target	doel
serotonin	serotonine
95	95
humans	mensen
died	overleed
n	n
favourable	gunstig
complement	aanvulling
sweden	zweden
rdw	rdw
frequently	vaak
flexion	flexie
features	beschikt
eyesight	gezichtsvermogen
bringing	brengen
tap	leidingwater
heritable	erfelijk
ribs	ribben
autism	autisme
working	werkzaam
designated	aangewezen
correct	correct
designated	aangeduid
great	grote
supervision	toezicht
allergenic	allergeen
tightly	strak
chelation	chelatietherapie
injuries	letsels
yoga	yoga
dealing	omgang
delivery	levering
only	alleen
unnecessary	onnodig
development	ontwikkeling
get	krijgt
white	wit
was	bevond
absence	afwezigheid
pale	bleek
egg	ei
courses	cursussen
independently	onafhankelijk
genus	geslacht
°	°
spoon	lepel
over	beëindigd
hygiene	hygiënische
loaded	geladen
groups	groepen
klein	klein
purified	gezuiverd
hepatotoxicity	hepatotoxiciteit
coloration	kleuring
found	geconstateerd
mites	mijten
quality	kwaliteit
disseminated	verspreid
commitment	inzet
tetracycline	tetracycline
hypothesis	hypothese
followed	gevolgd
idf	idf
turning	draaien
final	definitieve
letter	letter
part	deel
align	richten
flat	vlak
creams	crèmes
leads	leidt
cysts	cysten
close	dicht
partner	partner
curved	gebogen
mucus	slijm
threatening	bedreigend
scarring	littekens
engage	bezighouden
dark	donkere
condition	staat
multiplying	vermenigvuldigen
communications	communicatie
grains	korrels
remove	verwijderen
frequency	frequentie
paralysis	verlamming
defined	omschreven
ordinary	gewone
standing	staande
targeted	gerichte
how	hoe
measurement	maat
enquiry	onderzoek
his	zijn
recommending	bevelen
section	vak
developing	ontwikkelen
giving	geven
print	afdruk
monitors	monitoren
esophagus	slokdarm
vitamin	vitamine
darker	donkerder
frequent	frequente
pump	pomp
role	rol
behind	achteren
each	elk
ultimately	tenslotte
improved	verbeterde
intermediate	tussen
volume	volume
high	hoog
lab	laboratorium
hit	geraakt
showing	tonen
diameter	diameter
minimal	minimaal
hypnotic	hypnotische
incentives	prikkels
closed	gesloten
channel	kanaal
gram	gram
activities	werkzaamheden
it	het
means	middel
regulations	wettelijke
probe	sonde
concurrent	gelijktijdig
prevention	voorkoming
af	af
card	kaart
form	vorm
movement	beweging
hooves	hoeven
simple	eenvoudig
inactive	inactief
japan	japan
taste	smaak
kg	kg
fat	vet
b12	b12
busy	bezig
beat	kloppen
gestation	zwangerschap
filter	filter
children	kinderen
liver	lever
identical	identiek
horizontal	horizontale
curettage	curettage
orthodontics	orthodontie
counts	telt
hypertension	hypertensie
institutions	instellingen
reasonably	redelijk
chickenpox	waterpokken
spiritual	geestelijk
daily	dagelijkse
extra	extra
symmetric	symmetrisch
creating	creëren
depersonalization	depersonalisatie
international	internationaal
diploma	diploma
specialist	specialistische
lower	verlagen
wear	draagt
sense	zin
civilians	burgers
inborn	aangeboren
glaucoma	glaucoom
come	gekomen
interventions	ingrepen
names	namen
bvd	bvd
understand	begrijpen
physically	fysiek
functions	functioneert
american	amerikaanse
tablet	tablet
fully	geheel
tubing	buis
so-called	zogenoemde
indication	aanwijzing
short	kort
archetypes	archetypen
brace	brace
bird	vogel
deep	diepe
kill	doden
fistula	fistel
rigidity	stijfheid
3.5	3,5
finally	tenslotte
venipuncture	venapunctie
autoimmune	auto
external	externe
urea	ureum
masses	massa
already	reeds
price	prijs
years	jarenlang
attenuated	verzwakt
ld	ld
relieve	helpen
then	dan
stating	stellen
phase	fase
probably	vermoedelijk
time	tijd
lymphocytes	lymfocyten
purpose	doel
pass	doorlaat
judge	beoordelen
stressful	belastend
aware	bewust
fetal	foetus
drops	druppels
organism	organisme
meningitis	meningitis
advanced	geavanceerde
b6	b6
fiber	vezels
1.5	1,5
wanting	willen
sport	sport
reaching	bereiken
direction	richting
up	omhoog
stain	vlek
meninges	hersenvliezen
jejunum	darm
buy	kopen
manufacturers	fabrikanten
celiac	coeliakie
emotional	emotioneel
minimum	minimum
objectives	doelen
antidepressant	antidepressiva
is	is
12th	12e
fears	angsten
grows	groeit
balloon	ballonnetje
rpgn	rpgn
2007	2007
center	centrum
twentieth	twintigste
intensive	intensive
dru	dru
lowers	verlaagt
eventual	eventueel
show	blijkt
?	?
60	60
stimulus	stimulus
managed	beheerd
endoscope	endoscoop
until	totdat
case	geval
machinery	machines
positions	posities
filled	gevulde
esophageal	slokdarm
fifth	vijfde
staphylococcus	staphylococcus
weakness	zwakte
blow	slag
contractions	samentrekkingen
antagonist	antagonist
fight	vechten
going	gaat
from	uit
albert	albert
sedated	verdoofd
drinking	drinken
!	!
bonds	bindingen
athletes	sporters
usually	gewoonlijk
minister	minister
suspect	verdacht
gets	krijgt
technology	technologie
tract	tractus
myristic	myristinezuur
scars	littekens
call	heten
as	zoals
clavulanic	clavulaanzuur
ulnar	ulnaire
sympathetic	sympathische
training	trainingen
implantation	implantatie
parenteral	parenterale
multiplied	vermenigvuldigd
sites	plaatsen
vital	vitale
help	hulp
inhibition	remming
supplied	geleverde
through	doorgemaakt
outer	buitenste
end	eind
neurotransmitter	neurotransmitter
pure	zuivere
which	waarmee
town	stad
cpr	reanimaties
infants	zuigelingen
phosphate	fosfaat
exchanged	uitgewisseld
permitted	toegestaan
tuberculosis	tuberculose
accelerated	versneld
significantly	beduidend
new	nieuw
location	locatie
iih	iih
act	fungeert
think	menen
visits	bezoeken
dying	sterven
omitted	achterwege
presumably	vermoedelijk
double	dubbele
privacy	privacy
enabled	ingeschakeld
confined	beperkt
lasts	duurt
any	eventuele
1998	1998
nevertheless	toch
odd	vreemd
measurements	metingen
inguinale	inguinale
mucous	slijm
clot	stolsel
pulling	trekken
transformation	gedaanteverwisseling
vitro	vitro
large	groot
suspicious	verdacht
robert	robert
weapons	wapens
systematic	systematische
teaching	onderwijs
anencephaly	anencefalie
therapist	therapeut
individual	individueel
pathogen	pathogeen
wage	voeren
podiatry	pedicure
baby	baby
taken	ingenomen
relatives	familie
47	47
comply	voldoen
count	tellen
peritoneum	peritoneum
disposal	beschikking
produce	produceren
glomerulus	glomerulus
becomes	wordt
was	stond
successful	succesvolle
gain	krijgen
moulded	gegoten
transferred	overgebracht
spect	spect
fact	feit
death	overlijden
named	genaamd
introduced	geïntroduceerd
discoloration	verkleuring
staff	stafleden
ever	ooit
nerve	vagus
eliciting	uitlokken
cpr	hartmassage
charged	belast
dirt	vuil
soluble	oplosbare
parasite	parasiet
brachii	brachii
material	materiaal
neurology	neurologie
rim	rand
dosages	doseringen
leadership	leiding
placenta	placenta
canker	kanker
platelets	trombocyten
unwanted	ongewenste
men	mannen
distress	nood
reversed	omgekeerd
switch	schakelen
transient	voorbijgaande
hypnotic	gehypnotiseerde
basic	basis
fabricated	vervaardigd
estimation	schatting
genetic	genetisch
custom	gewoonte
subject	onderwerp
suppression	onderdrukking
devoted	besteed
laser	laser
asphyxia	verstikking
bacterium	bacterie
monitors	bewaakt
cancers	kankers
because	aangezien
hospital	gasthuis
what	wat
recombinant	recombinant
constrictor	sluitspier
preparations	preparaten
progression	progressie
influence	invloed
soon	drä
endometrium	endometrium
rubella	rodehond
septal	septum
asked	gevraagd
deliver	leveren
must	moeten
belonging	behorende
suppliers	leveranciers
embryonic	embryonale
minimize	verkleinen
market	marktwerking
inheritance	overerving
haematuria	hematurie
neuralgia	neuralgie
daily	daags
prepared	geprepareerd
state	toestand
corticosteroids	corticosteroïden
96	96
adjustment	aanpassing
slight	gering
showed	liet
arrested	aangehouden
umbilicus	navel
examples	voorbeelden
relation	relatie
hyperthermia	hyperthermie
penis	penis
microsleeps	microslaap
requirements	eisen
clinical	klinische
propensity	neiging
wash	wassen
stenosis	stenose
team	team
petechial	petechiën
swallowing	slikken
delirium	delirium
paragangliomas	paragangliomen
vigorously	krachtig
can	kunnen
velocity	snelheid
future	toekomstige
make	ervoor
positively	positief
reviewed	beoordeeld
sutured	gehecht
donor	donor
default	standaard
does	doet
indicated	aangegeven
copies	kopieën
ceramic	keramische
provoked	uitgelokt
serve	dienen
2000	2000
wish	wens
follicle	follikel
starch	zetmeel
parent	ouder
is	wordt
rash	huiduitslag
complicated	gecompliceerde
nerves	zenuwen
white	witte
consumption	consumptie
memory	geheugen
1900	1900
nocturnal	nachtelijke
automatic	automatisch
beneficial	gunstig
out	eruit
organic	organische
took	nam
deceased	overleden
calcification	calcificatie
gumline	tandvlees
strike	staken
encompass	omvatten
left	linker
suturing	hechten
digits	cijfers
differing	uiteenlopende
ones	degenen
liquids	vloeistoffen
surface	oppervlakte
viii	viii
assessing	beoordelen
poor	slechte
narrow	smalle
cisgenesis	cisgenese
diarrheal	diarree
hardly	nauwelijks
present	aanwezige
pancreas	alvleesklier
fat	dik
demonstrating	aantonen
significantly	significant
because	doordat
measure	maatstaf
potency	sterkte
obtained	verkregen
paralyzed	verlamd
grant	verlenen
alternative	alternatieve
stay	verblijf
inadvertently	onbedoeld
iodine-123	jodium-123
vein	aderen
trapped	vastzitten
lipomas	lipomen
sixth	zesde
asphyxiation	verstikking
income	inkomen
round	ronde
once	eenmaal
pierre	pierre
issued	afgegeven
infections	infecties
incorrect	onjuist
supply	levering
benign	goedaardig
accumulate	ophopen
skin	huid
hemorrhagic	hemorragische
evening	avond
infertility	onvruchtbaarheid
75	75
brace	beugel
social	maatschappelijke
responses	reacties
atypical	atypische
corresponding	bijbehorende
endemic	endemisch
unstable	instabiel
for	wegens
excision	excisie
colostomy	colostoma
female	vrouwelijke
segment	segment
active	actief
examines	onderzoekt
spleen	milt
shapes	vormen
great	groot
osteoporosis	osteoporose
crushing	breken
evoked	opgeroepen
nose	neus
weight	gewicht
malignant	kwaadaardig
asked	gesteld
change	verandering
natural	natural
deciding	beslissen
conscious	bewust
intact	intact
hemoglobinuria	hemoglobinurie
call	oproepen
false	foutieve
figures	cijfers
jaw	kaak
x	x
red	rood
texture	structuur
breastfeeding	borstvoeding
behaviour	gedrag
relying	vertrouwen
nations	naties
lactating	zogende
solution	oplossing
acidosis	acidose
image	beeld
dogs	honden
spatial	ruimtelijke
dilute	verdund
preceded	voorafgegaan
complement	complement
for	voor
hospital	hospital
medulla	medulla
properly	behoorlijk
proving	bewijzen
temporarily	tijdelijk
partially	dele
atmosphere	sfeer
insects	insecten
dementia	dementie
assure	verzekeren
successful	succesvol
services	diensten
fuel	brandstof
tiredness	vermoeidheid
utero	baarmoeder
nowadays	tegenwoordig
egypt	egypte
disturbing	storende
read	afgelezen
fear	angst
banned	verboden
septum	septum
display	tonen
reliance	vertrouwen
ulna	ellepijp
impetigo	krentenbaard
yet	nog
f.	f.
overdose	overdosering
george	george
inhaled	ingeademd
march	maart
medial	mediale
opposite	tegenover
primordial	oorspronkelijk
bulk	massa
mutations	mutaties
oxygenated	zuurstofrijk
bolus	pil
natural	natuurlijke
dna	dna
england	engeland
may	mogen
phospholipids	fosfolipiden
become	geworden
megakaryocytes	megakaryocyten
narcotic	verdovend
need	hoeven
future	toekomst
roughly	ongeveer
reflex	reflex
select	kiezen
reached	bereikt
undergo	ondergaan
train	trainen
ras	ras
food	voeding
symbol	symbool
modify	wijzigen
treatment	kuur
damage	beschadigen
heroin	heroïne
blindness	blindheid
quickly	snel
aureus	aureus
need	noodzaak
liquid	vloeibare
determined	vastgesteld
core	kern
synthesized	gesynthetiseerd
down	neer
ligament	ligament
heal	genezen
recovers	herstelt
reduced	verlaagde
belly	buik
erythematosus	erythematodes
*	*
gone	weg
300	300
hold	vasthouden
abnormalities	afwijkingen
whether	hetzij
tumours	tumoren
studies	studies
placement	plaatsing
fraction	fractie
why	waarom
achieved	gehaald
strictures	vernauwingen
expelled	uitgestoten
just	net
vision	visie
cows	koeien
design	opzet
defined	bepaald
mistake	fout
research	onderzoek
random	willekeurig
min	min
deficiency	deficiëntie
social	sociaal
hidden	verborgen
paid	betaald
externally	uitwendig
ileum	kronkeldarm
cream	crème
menses	menstruatie
it	eraan
regimen	dieet
ecg	ecg
features	kenmerken
alexander	alexander
do	doen
military	militaire
working	werkende
humane	humaan
ways	manieren
basically	eigenlijk
bowel	darm
laceration	scheur
package	pakket
run	doorlopen
usage	gebruik
constituents	bestanddelen
tests	testen
smallest	kleinste
medial	middel
constriction	samentrekking
wearer	drager
veterinarian	dierenarts
however	echter
increase	vermeerderen
fall	daling
hours	uur
straining	inspanning
irrespective	ongeacht
husband	man
pulmonary	pulmonaire
temporary	tijdelijk
check	controleren
continual	voortdurend
helpful	nuttig
ratio	ratio
..	..
described	beschreef
decide	besluiten
cardiopulmonary	hart
100	100
broad	breed
saved	bewaard
tardive	tardieve
porcine	varkens
independent	onafhankelijk
criteria	criteria
porcelain	porselein
widening	verwijding
offer	aanbieden
stem	stam
set	ingesteld
hormesis	hormese
daytime	dag
yeast	gist
infant	zuigelingenvoeding
thought	dacht
stricture	vernauwing
despite	desondanks
lma	lma
pleural	pleuravocht
atherosclerosis	atherosclerose
anesthesiology	anesthesiologie
usual	gebruikelijk
deficit	tekort
see	zie
digitoxin	digitoxine
territory	gebied
elastic	elastische
imaging	imaging
wear	slijtage
ability	vermogen
calculate	berekenen
additive	toevoeging
mention	vermeld
affected	beïnvloed
conducting	uitvoeren
displayed	weergegeven
oil	olie
pulmonary	pulmonale
stomatitis	stomatitis
herbs	kruiden
primordial	primordiale
analogue	analoog
hepatic	lever
transported	getransporteerd
he	hij
trachea	trachea
anomalous	abnormaal
tight	strak
health	gezondheidsproblemen
guard	bewaken
concentrated	geconcentreerde
biologic	biologisch
cervical	cervicale
reused	hergebruikt
higher	hogere
connected	verbonden
adjust	aanpassen
regulate	reguleren
papers	stukken
diabetes	suikerziekte
be	verkeren
telephone	telefoon
immunotherapy	immunotherapie
compensation	vergoeding
term	termijn
started	begon
projects	projecten
slow	langzaam
air	lucht
healthcare	zorginstellingen
held	gehouden
cdp323	cdp323
gras	gras
hurt	pijn
expectation	verwachting
consensus	consensus
exact	exacte
decreased	afgenomen
boil	koken
hot	heet
other	anders
jaundice	geelzucht
past	voorbij
pathogen	ziekteverwekker
xa	x
feed	aanzet
antibody	antilichaam
power	vermogen
especially	name
clients	cliënten
rumen	maag
copy	kopie
successfully	geslaagd
eight	acht
discouraged	afgeraden
cm	cm
damaging	schadelijk
synonymous	synoniem
generalised	gegeneraliseerde
few	weinig
malnutrition	ondervoeding
dies	sterft
vets	dierenartsen
define	bepalen
nearly	bijna
range	reeks
opportunity	kans
myelin	myeline
japanese	japanse
system	stelsel
fundamental	fundamentele
polycythemia	polycythemie
confirmed	bevestigd
belongs	behoort
hands	handen
summary	overzicht
4th	4e
occurs	treedt
modification	wijziging
minimally	minimaal
trichomoniasis	trichomoniasis
365	365
effective	effectiever
h.	h.
meiosis	meiose
newts	salamanders
&amp;	&amp;
pharmacists	apothekers
an	een
yields	oplevert
supplied	ingevoerd
measles	mazelen
meridians	meridianen
agree	overeenkomen
limited	beperkte
significantly	aanzienlijk
triglycerides	triglyceriden
surgery	chirurgie
from	van
voiding	plassen
used	gebruikte
rarely	zelden
become	word
palliative	palliatieve
drained	afgevoerd
obstetrician	verloskundige
tied	gebonden
demonstrate	aantonen
unknown	onbekend
miscarriage	miskraam
colors	kleuren
through	door
country	land
implant	implantaat
oesophagus	slokdarm
microorganism	micro-organisme
burgdorferi	burgdorferi
call	noemt
complex	complexe
pharmaceutical	farmaceutische
profile	profiel
conduct	gedrag
assume	aannemen
acetaminophen	paracetamol
asphyxia	asfyxie
unconscious	onbewuste
neuromyotonia	neuromyotonie
recognizable	herkenbaar
blood	bloed
frequent	veelvuldig
instance	instantie
processes	processen
personal	persoonlijk
place	plaatsen
molds	schimmels
dated	verouderd
arachidonic	arachidonzuur
400	400
strictly	strikt
hyperpigmentation	hyperpigmentatie
known	bekende
coated	bedekt
bind	binden
cardiac	hart
order	volgorde
experienced	ervaren
cardioversion	cardioversie
support	support
essentially	wezen
explained	verklaard
numb	verdoofd
communicable	overdraagbare
eggs	eitjes
incorporate	nemen
wallenberg	wallenberg
wire	draad
link	link
free	vrije
sedation	verdoving
morphology	morfologie
objections	bezwaren
africa	afrika
ointment	zalf
adapted	aangepast
stairs	trap
currently	momenteel
least	minste
known	bekendste
l	l
treatment	behandeling
states	staten
old	oude
room	kamer
examine	onderzoeken
choose	kies
council	raad
map	kaart
linalool	linalool
ensue	volgen
see	bekijken
promotion	bevordering
sperm	sperma
industry	industrie
afterwards	daarna
objects	voorwerpen
generation	generatie
intensive	intensieve
otherwise	anders
suture	hechting
assisted	geholpen
proceedings	werkzaamheden
concentrate	concentreren
deeper	diepere
cdt	cdt
during	gedurende
cause	teweegbrengen
military	leger
practical	praktisch
task	taak
species	diersoorten
tendency	neiging
turn	wisseling
foundation	oprichting
lips	lippen
remains	achterblijft
prone	vatbaar
valves	kleppen
short-term	kortdurend
1960s	1960
proof	bewijs
fatigue	vermoeidheid
smell	ruiken
prevents	voorkomt
micro-organisms	micro-organismen
families	families
conclusion	conclusie
injuries	blessures
&quot;	&quot;
treated	behandelde
succeed	lukt
so-called	zogenaamd
stomach	maag
microscope	microscoop
happened	gebeurd
neuropathy	neuropathie
thought	gedacht
observing	observeren
fixed	vast
transports	vervoert
wine	wijn
parallel	parallel
performance	uitvoering
execution	uitvoering
therefore	daarom
malaria	malaria
provide	voorzien
previous	vorige
gives	geeft
cosmetic	cosmetische
%	%
whom	wie
well	goede
medical	geneeskundig
euthanasia	euthanasie
featured	gekenmerkt
categories	categorieën
vet	dierenarts
near	dichtbij
commerce	handel
15	15
food	voedselbank
mutual	onderlinge
social	sociale
inability	onvermogen
choice	keus
reach	bereiken
angry	ontstoken
particulates	deeltjes
eaten	gegeten
alternative	alternatief
revealed	gebleken
2005	2005
serological	serologische
empire	rijk
pass	overgaan
paraganglioma	paragangliomen
adjusting	aanpassen
aortic	aorta
soil	bodem
plants	planten
goals	doelen
alternately	afwisselend
accidentally	toevallig
peritoneal	peritoneale
sores	blaasjes
to	naar
designation	aanduiding
stance	houding
accelerated	versnelde
hygienist	mondhygiënist
certainty	zekerheid
diluted	verdund
altered	gewijzigd
makes	merken
site	plaats
city	stad
calculated	berekend
paresthesia	paresthesie
proliferation	woekering
aged	oud
nervosa	nervosa
delusions	wanen
snail	slak
sophisticated	geavanceerde
confirming	bevestigen
los	los
commercial	commerciële
parasympathetic	parasympathische
repressed	onderdrukt
dried	droog
difference	verschil
homeopathy	homeopathie
bone	bot
highest	hoogste
brand	merk
division	deling
treponema	treponema
more	meer
salts	zouten
active	actieve
granules	korrels
resorbed	geresorbeerd
image	afbeelding
exists	bestaat
loose	losse
traditional	traditionele
well-being	welzijn
dropping	vallen
treating	behandelen
cause	aanrichten
tail	staart
passed	doorgegeven
velopharyngeal	velofaryngeale
profound	ingrijpende
koch	koch
house	huis
iliac	iliaca
clotting	stolling
adequate	adequaat
move	bewegen
conclusions	conclusies
mandatory	verplicht
ethics	ethiek
mris	mri
identified	gesignaleerd
heat	hitte
bleeding	bloeden
thick	dik
sensitive	gevoeliger
polish	poetsen
denoted	aangeduid
literally	letterlijk
therapies	therapieën
callus	eelt
moment	ogenblik
indomethacin	indomethacine
diagnosed	gediagnosticeerd
intravenously	intraveneus
imaging	beeldvormend
myelofibrosis	myelofibrose
collect	verzamelen
load	last
elements	elementen
referred	genoemd
sensitive	gevoelige
reliability	betrouwbaarheid
fingers	vingers
tibia	scheenbeen
faulty	defect
disruption	ontwrichting
describing	beschrijven
automatic	automatische
lower	zwakker
location	ligging
anesthesiologists	anesthesiologen
instructions	aanwijzingen
either	oftewel
techniques	technieken
endoscopy	endoscopie
activates	activeert
dentistry	tandheelkunde
positive	positieve
substance	substantie
psychasthenia	psychasthenie
title	titel
dense	dicht
salt	zouten
carcinoma	carcinoom
platelets	bloedplaatjes
thousands	duizenden
spread	verspreiding
reality	realiteit
important	belangrijk
oneself	zichzelf
journal	journal
concomitantly	gelijktijdig
synthesis	synthese
weakened	verzwakte
sits	zit
cloth	kleding
1996	1996
medicines	geneesmiddelen
1987	1987
mantoux	mantoux
oncologist	oncoloog
asthma	asthma
years	jaren
matching	koppeling
percent	procent
superficial	oppervlakkig
modern	moderne
demonstration	demonstratie
killing	doden
increased	toegenomen
days	dagen
collected	verzameld
generally	algemeen
physiology	fysiologie
42	42
employed	werknemers
beside	daarnaast
manifestation	manifestatie
amphibians	amfibieën
radioactive	radioactief
arm	arm
donate	doneren
guard	wacht
access	toegang
veins	aderen
about	omtrent
macrophages	macrofagen
composite	samengesteld
compared	opzichte
decreases	daalt
leisure	vrije
cope	omgaan
same	hetzelfde
.	.
cleaned	gereinigd
ventilation	ventilation
but	doch
dissolving	oplossen
resistance	resistentie
through	doorheen
onset	begin
albicans	albicans
reduce	verminderen
recordings	opnames
popularity	populariteit
greek	grieks
discontinued	stopgezet
face	gezicht
end	einde
discovery	ontdekking
sports	sporten
chooses	kiest
difficult	lastig
ca	ca
possessing	bezit
repeating	herhalen
nighttime	nacht
community	gemeenschap
stand	staan
bloodstream	bloedbaan
vertigo	duizeligheid
save	behouden
feet	voeten
prompted	gevraagd
disrupted	verstoord
high	hoge
pay	betalen
bladders	blazen
out	uit
vessel	vaatwand
food	voedsel
drug	medicamenteuze
prefrontal	prefrontale
turned	gedraaid
minerals	mineralen
used	gebruikt
typical	typisch
compound	verbinding
pushed	geschoven
radiologist	radioloog
seldom	zelden
extracellular	extracellulaire
relative	relatieve
clear	duidelijk
smooth	gladde
prions	prionen
stimulus	prikkel
a	eén
5	5
painful	pijnlijke
effective	effectieve
pa	vader
exclusively	uitsluitend
seeds	zaden
psychosis	psychose
malfunction	storing
founded	richtte
urethra	urinebuis
regulates	regelt
scintigraphy	scintigrafie
justice	justitie
since	sindsdien
epithelium	epitheel
albuminuria	albuminurie
workup	opbouwen
fetal	foetaal
women	vrouwen
attributed	toegeschreven
intentionally	opzettelijk
a	a
genome	genoom
cry	huilen
real	echt
dates	data
gender	geslacht
anal	anale
cook	koken
moving	bewegende
toe	teen
analogous	analoog
implantable	implanteerbare
separate	scheiden
tests	tests
substances	stoffen
catheters	katheters
peel	schil
forceful	krachtig
brain	hersenen
snakes	slangen
scan	scan
syncope	syncope
binds	bindt
pathological	pathologisch
thousand	duizend
occupy	bezighouden
vegetables	groenten
attempting	proberen
aid	hulpmiddel
straight	recht
ineffective	onwerkzaam
taking	inneming
newborn	pasgeborene
meninges	hersenvlies
composition	samenstelling
dehydration	uitdroging
strokes	beroertes
employment	werk
decay	verval
chiefly	hoofdzakelijk
required	vereiste
worms	wormen
adults	volwassenen
blood	bloedafname
complete	voltooien
navicular	naviculare
thick	dikke
black	zwarte
relaxation	ontspanning
therapeutic	therapeutisch
inhalational	inhalatie
polyuria	polyurie
investigation	onderzoek
father	vader
lack	ontbreken
right	rechts
resulting	ontstane
vapor	damp
ganglion	ganglion
about	hierover
s.	s.
art	kunst
prohibited	verboden
procedure	procedure
product	product
14	14
sevoflurane	sevofluraan
discovered	ontdekt
proteinuria	proteïnurie
mostly	meestal
efficiently	efficiënter
obesity	obesitas
bag	zak
spirometer	spirometer
gold	goud
migrate	migreren
accepted	geaccepteerd
vasoconstriction	vasoconstrictie
crystals	kristallen
smoking	roken
laparoscopically	laparoscopisch
midwife	verloskundige
substance	stof
arose	ontstond
elbow	elleboog
virus	virus
inconvenience	ongemak
fibers	vezels
consisting	bestaande
panic	paniek
method	werkwijze
thrombus	trombus
communication	communicatie
coronary	coronaire
final	laatste
compulsive	gedwongen
fertile	vruchtbare
ratio	verhouding
targeted	doelgericht
more	verder
prohibited	belemmerde
decreased	verminderde
local	plaatselijke
property	eigenschap
whereas	terwijl
exceeded	overschreden
completed	aangevuld
vast	groot
stupor	verdoving
really	echt
markers	merkers
command	bevelen
al	al
swelling	zwelling
depending	afhankelijk
digestion	spijsvertering
articular	articulair
without	zonder
information	informatie
intelligence	intelligentie
molars	kiezen
extreme	extreme
researching	onderzoeken
loss	verlies
redness	roodheid
status	status
blockade	blokkade
expressed	uitgedrukt
nothing	niets
ovum	eicel
hematuria	hematurie
school	school
twenty	twintig
channels	kanalen
dietary	dieet
electrons	elektronen
local	plaatselijk
pathologic	pathologische
mothers	moeders
harmless	onschadelijk
held	hield
dermatophytes	dermatofyten
experiments	experimenten
exchange	centrale
ulcer	zweer
torn	gescheurde
tubules	tubuli
system	systeem
pectoris	pectoris
traumatic	traumatische
psychiatrists	psychiaters
bright	heldere
release	afgifte
mounted	aangebracht
threatened	bedreigde
critical	kritische
convulsions	krampen
quantities	hoeveelheden
heavy	zware
button	knoop
forensic	forensisch
secretion	uitscheiding
2011	2011
characteristic	kenmerkend
duodenal	twaalfvingerige
thorax	thorax
juveniles	jongeren
observed	waargenomen
until	tot
comprehend	begrijpen
hopes	hoopt
developed	ontwikkeld
side-effect	bijwerking
internet	internet
mold	schimmel
strip	strip
revised	herzien
neuropsychiatry	neuropsychiatrie
divergent	afwijkend
locked	afgesloten
comprises	bestaat
averaged	gemiddeld
dental	tandheelkundige
gas	gas
potential	potentieel
political	politieke
supportive	ondersteunende
enlarging	vergroten
freed	vrijgemaakt
muscles	spieren
operates	opereert
decision	besluit
deoxygenated	zuurstofarme
care	verzorging
fold	plooien
distinctive	kenmerkend
crystal	kristallen
society	society
stays	verblijven
part	onderdeel
alters	verandert
bed	bed
dutch	nederlands
option	optie
too	te
mainly	voornamelijk
arteries	arteriën
habitual	gewoon
awareness	bewustzijn
protein	protein
united	verenigd
must	moet
increases	vergroot
peripheral	perifeer
spontaneously	spontaan
pallidum	pallidum
position	positie
surrounding	omliggend
instrument	instrument
else	anders
searching	zoeken
odor	geur
2001	2001
enough	voldoende
treatable	behandelbaar
primarily	allereerst
similar	soortgelijk
pale	bleke
toxic	giftig
protection	beschermende
perhaps	misschien
directives	richtlijnen
various	allerlei
create	creëren
origins	oorsprong
blastocyst	blastocyste
trend	trend
microscopic	microscopische
legal	wettelijk
disposable	beschikbaar
beverage	drank
this	dit
shoulders	schouders
advised	geadviseerd
swim	zwemmen
kinds	soorten
litre	liter
commission	commissie
ketones	ketonen
organization	organisatie
machine	machine
gums	tandvlees
voltage	spanning
experimental	experimentele
weak	zwakke
vena	vena
behave	gedragen
folate	foliumzuur
terminal	terminale
intakes	inname
pulled	getrokken
accessible	toegankelijk
maximal	maximaal
effective	effectief
anyone	iedereen
specific	specifiek
anatomy	anatomie
toxicity	toxiciteit
expensive	duur
inguinal	lies
inadequate	onvoldoende
anesthetized	verdoofd
se	se
overall	algemene
markedly	aanmerkelijk
tumors	tumoren
facts	feiten
multiple	multiple
though	hoewel
combined	gecombineerde
fishes	vissen
resorption	resorptie
interest	belang
return	terugkeer
slow	traag
treat	treat
subclavian	subclavia
than	dan
exception	uitzondering
oregon	oregon
changing	wisselende
possibility	mogelijkheid
appearance	uitstraling
accurately	nauwkeuriger
causes	veroorzaakt
vigorous	krachtig
enzyme	enzym
glomeruli	glomeruli
declaration	verklaring
rice	rijst
unfortunately	helaas
vitamins	vitaminen
immunologic	immunologische
convoluted	ingewikkelde
burning	brandend
65	65
theoretical	theoretische
stool	ontlasting
burning	branderig
belong	behoren
initiative	initiatief
wagner	wagner
food	eten
escherichia	escherichia
diseases	ziekten
arterioles	arteriolen
there	er
finds	vindt
aphasics	afasie
intake	inname
isolated	geïsoleerd
insomnia	insomnie
chromosomes	chromosomen
series	reeks
approach	aanpak
calories	calorieën
theory	theorie
blow	klap
stimulates	stimuleert
stay	verblijven
clothing	kleding
influences	invloeden
accidents	ongevallen
cross	kruis
curable	genezen
intraocular	intra-oculaire
cataract	staar
1	1
gray	grijze
combine	combineren
have	hebt
rehabilitative	revalidatie
extreme	extreem
19th	19e
customized	aangepaste
incurred	gemaakt
details	gegevens
fragments	fragmenten
homeopathic	homeopathische
hematoma	hematoom
measurement	meting
dies	lijdt
rare	zeldzame
pictures	beelden
inside	inwendige
naked	blote
final	uiteindelijke
vaccine	vaccin
start	begin
generations	generaties
dilutions	verdunningen
metals	metalen
declared	gedeclareerd
data	gegevens
checked	gecontroleerd
there	daaruit
tear	scheur
offers	biedt
society	maatschappij
pars	pars
hygiene	hygiëne
biofeedback	biofeedback
nutrient	voedingsstof
accessible	beschikbaar
x-rays	röntgenstralen
food	voedings-
deadly	dodelijk
denotes	geeft
phrases	zinnen
whilst	terwijl
safe	veilig
fungal	schimmel
antigen	antigeen
purposes	doeleinden
caffeine	cafeïne
ready	gereed
circumstances	situatie
which	welk
anaesthesia	anesthesie
drink	drank
iron	ijzer
congenital	aangeboren
steady	vast
antibody	antistof
cut	snee
tarsometatarsus	tarsometatarsus
absolute	absolute
enables	maakt
parts	onderdelen
assay	assay
population	populatie
venous	veneuze
professions	beroepen
retained	vastgehouden
care	care
birth	geboorte
which	welke
road	weg
prey	prooi
mechanical	mechanisch
smaller	kleinere
supports	ondersteunt
palpation	palpatie
affecting	invloed
decreased	gedaald
necessary	noodzakelijke
subsequently	vervolgens
obstetrical	verloskundige
suspicion	verdenking
thyroid	schildklier
old	oud
proceed	doorgaan
muscle	spier
want	willen
empty	leeg
recognized	herkend
interfering	storende
sexually	seksueel
chances	kansen
granted	verleend
reduced	verminderd
cannulae	buisje
commercially	commercieel
anterior	voorste
substituted	vervangen
market	markt
science	wetenschap
zero	nul
clean	schoon
coupled	gepaard
variously	verschillend
images	afbeeldingen
research	research
lose	verliezen
it	ervan
implementation	implementatie
synonymously	synoniem
recommended	aangeraden
division	afdeling
takes	duurt
legally	wettelijk
atropine	atropine
academic	academische
hysteria	hysterie
organic	biologische
reasons	redenen
desirable	gewenst
layers	lagen
inception	begin
our	onze
issue	kwestie
wrapping	omhulsel
full	volledige
how	hoeverre
decrease	afname
potential	eventueel
described	beschreven
rinsed	gespoeld
compound	samenstelling
laws	wetten
block	blok
half	halve
pathogens	pathogenen
report	rapport
mechanisms	mechanismen
subcutaneous	subcutane
labeled	gelabeld
appeared	verschenen
edta	edta
orifice	opening
raise	verhogen
survival	overlevingskans
brains	hersenen
common	gemeenschappelijke
improper	onjuist
points	punten
final	definitief
normally	normaliter
can	kunt
protein	eiwit
technique	techniek
including	inclusief
complete	complete
recovery	herstel
so-called	z.g.
disturbed	verstoord
the	the
microsleep	microslaap
5,000	5000
freely	vrij
scientific	wetenschappelijk
improved	verbeterd
feel	voelen
stronger	sterker
grown	gekweekt
albumin	albumine
dividing	verdeling
abscesses	abcessen
placental	placenta
still	nog
diffusion	diffusie
securely	vast
&apos;	&apos;
interaction	interactie
guideline	richtlijn
flowers	bloemen
latest	laatste
block	blokkeren
standards	normen
stimulation	stimulatie
screening	screenen
content	inhoud
dirty	vuil
solving	oplossen
molecular	moleculaire
apex	top
carries	draagt
once	eens
phone	telefoon
lifetime	levensduur
stick	kleven
cloning	klonen
table	tabel
vena	ader
caregivers	zorgverleners
profession	beroep
steps	stappen
alone	alleen
means	betekent
mind	geest
athlete	atleet
provisions	voorzieningen
patient	patiënt
consequently	zodoende
beat	slaan
examined	onderzocht
him	hem
goal	doelstelling
real	echte
dsm	dsm
evaluation	evaluatie
quicker	sneller
disturb	verstoren
diagnostic	diagnostische
sheep	schapen
foundation	foundation
urine	urine
smith	smith
parturition	bevalling
course	verloop
principally	hoofdzakelijk
extraction	extractie
lift	opheffen
sweat	zweten
standard	standaard
transport	transport
watch	observeren
rear	kweken
systematic	systematisch
hours	uren
plant	plant
customary	gebruikelijk
germany	duitsland
centrifuge	centrifuge
better	betere
copy	exemplaar
ulcers	ulcera
vegetable	plantaardige
personnel	personeel
predisposition	aanleg
interpreted	geïnterpreteerd
observation	waarneming
weak	zwak
23	23
discovering	ontdekken
clock	klok
possible	mogelijk
tendon	pees
watching	volgen
principle	principe
fight	bestrijden
cough	hoesten
advanced	gevorderd
surrounded	omgeven
anything	iets
pharynx	farynx
answer	antwoord
age	leeftijd
shoes	schoenen
chromosome	chromosoom
divided	gedeeld
complete	compleet
massage	massage
these	deze
select	selecteren
transport	transporteren
mark	merken
pregnant	zwanger
funded	gefinancierd
prescribing	voorschrijven
slows	vertraagt
drawbacks	nadelen
that	die
land	land
conventional	gangbare
tough	harde
receive	ontvangen
inhalation	inhalatie
sources	bronnen
enhancing	verbeteren
brown	bruine
mandible	kaak
automatically	automatisch
amplify	versterken
localization	lokalisatie
average	gemiddelde
some	bepaalde
medical	medical
policy	beleid
after	nadat
weather	weer
solutions	oplossingen
correctly	correct
indicated	aangeduid
showed	toonde
spanish	spaanse
rupture	ruptuur
often	vaak
dat	dat
angiography	angiografie
listen	luisteren
manipulate	manipuleren
fibres	vezels
medical	medisch
orifices	openingen
anus	anus
interventions	interventies
surround	omgeven
reflexes	reflexen
j.	j.
psychological	psychologische
traces	sporen
administered	toegediend
contribution	bijdrage
unconsciousness	bewusteloosheid
subsequently	nadien
intervention	tussenkomst
digoxin	digoxine
bit	beetje
tested	getest
getting	krijgen
away	weg
criticism	kritiek
airway	ademweg
practised	beoefend
because	want
materia	materia
caloric	warmte
stomach	maagwand
method	methode
prescribe	voorschrijven
charles	charles
transplantation	transplantatie
outside	buiten
foundation	stichting
processing	verwerking
ml	ml
bank	bank
ruminants	herkauwers
valuable	waardevolle
contrast	contrastmiddel
mild	milde
plausible	aannemelijk
diagnostics	diagnostiek
prove	bewijzen
ending	einde
hollow	holle
dutch	nederlanders
virulent	giftig
recent	recente
haemorrhagic	hemorragische
decrease	verminderen
minutes	minuten
radius	spaakbeen
worldwide	wereldwijd
setting	omgeving
bundle	bundel
systems	systemen
violent	heftige
to	to
break	breken
additional	extra
effectively	effectief
all	allemaal
cause	veroorzaken
york	york
doc	dokter
steel	stalen
learning	leren
interpretation	interpretatie
arms	armen
bloodstream	bloedstroom
paramedics	paramedici
dentists	tandartsen
edema	zwelling
recessive	recessief
tryptophan	tryptofaan
which	waarvoor
network	netwerk
capsules	capsules
evoke	oproepen
orthodontist	orthodontist
®	®
defense	afweersysteem
intensity	intensiteit
naturally	nature
pinch	knijpen
previous	eerdere
functional	functionele
divers	verschillend
judicial	gerechtelijk
mite	mijt
months	maanden
strengthen	versterken
carotid	carotis
level	peil
fetus	foetus
local	lokale
cats	katten
mammaprint	mammaprint
cup	kop
symptom	symptoom
cup	cup
surgery	heelkundige
epo	epo
pathology	pathologie
forgetting	vergeten
bipolar	bipolaire
common	gemeen
insurers	verzekeraars
avoided	vermeden
discourage	tegengaan
ingest	inslikken
separating	scheiden
touch	tast
english	engels
yellow	gele
chemical	chemisch
manufactured	vervaardigd
apart	uiteen
muscles	oogspieren
first	eerste
close	dichtbij
active	werkzame
hemolysis	hemolyse
it	ernaar
defects	defecten
low	laag
aggressive	agressieve
push	dringen
happening	gebeurtenis
thin	dunne
noticeable	merkbaar
opens	uitmondt
in	in
dry	drogen
irregular	onregelmatig
cosmetically	cosmetisch
quick	snel
reliable	betrouwbaar
soap	zeep
triage	triage
angina	angina
operation	werking
adequate	voldoende
side	zijkant
is	bevindt
intrinsic	intrinsieke
european	europese
admitted	toegelaten
pace	tempo
breathe	ademhalen
characteristic	kenmerkende
medicines	medicijnen
anemia	anemie
australia	australië
anemia	bloedarmoede
direct	direct
attendance	opkomst
contaminated	besmet
g.	g.
dosage	dosering
sclerosis	sclerose
extensively	uitgebreid
complications	complicaties
health	gezondheidszorg
lifespan	levensduur
bandage	verband
-	—
mental	mentale
inside	binnen
crown	kroon
parents	ouders
societal	maatschappelijke
ground	gronden
csf	hersenvocht
terms	termen
every	iedere
fetal	foetale
way	manier
seconds	seconden
preceding	voorafgaande
july	juli
lumbar	lumbale
color	kleur
intracellular	intracellulaire
gram-positive	gram-positieve
deviations	afwijkingen
moisture	vocht
narrow	nauw
coarse	grof
consent	toestemming
phlebotomy	aderlaten
dermatology	dermatologie
13	13
risk	risico
relate	vertellen
cells	cellen
small	klein
computer	computer
screening	screening
1971	1971
hepatomegaly	hepatomegalie
visit	bezoek
plate	plaat
enough	genoeg
these	zulke
lowered	verlaagd
platelet	bloedplaatjes
important	belangrijke
needed	needed
kind	soort
fall	dalen
sickness	ziekte
borderline	grens
leper	lepralijder
powder	poeder
alert	alarm
john	john
stopped	gestopt
underestimated	onderschat
really	werkelijk
content	gehalte
carry	dragen
cattle	rundvee
plexus	plexus
nutrition	voeding
therapeutic	therapeutische
step	stap
emdr	emdr
sedatives	sedativa
bleach	bleken
cell	cell
different	verschillende
girls	meisjes
20th	20e
you	u
bleed	aderlaten
handle	handvat
earlier	vroeger
today	heden
moderate	matig
member	lid
fall	val
accompany	begeleiden
nature	natuur
2008	2008
offset	compenseren
direct	directe
sold	verkocht
prolactinoma	prolactinoom
willebrand	willebrand
concerns	zorgen
evaluation	evalueren
should	moeten
perinatal	perinatale
resolve	oplossen
runny	vloeibaar
of	van
bottom	bodem
capacity	capaciteit
pulmonary	long
physiologic	fysiologisch
way	weg
end	uiteinde
religious	religieus
difficult	moeilijke
varied	afwisselend
turns	bochten
nausea	misselijkheid
endocrine	endocriene
consisted	bestond
characteristic	karakteristiek
we	we
expected	verwacht
fibre	vezel
called	genoemd
cardiac	cardiale
increase	stijging
surgical	chirurgische
analog	analoog
read	lezen
category	categorie
antibodies	antistoffen
second	tweede
rule	regel
stress	spanning
compounds	verbindingen
metres	meter
arises	ontstaat
point	punt
helps	helpt
recipe	recept
gravity	ernst
pregnant	zwangere
actually	feite
sos	sos
membership	leden
vertebrate	gewervelde
acupuncture	acupunctuur
hot	hete
strep	streptokokken
approved	goedgekeurd
divide	verdelen
recognizing	herkennen
intercourse	gemeenschap
useful	nuttig
responsible	verantwoordelijk
decided	bepaald
passive	passief
barrier	barrière
bicarbonate	bicarbonaat
emotional	emotionele
origin	oorsprong
overall	totale
syndromes	ziektebeelden
biggest	grootste
investigating	onderzoeken
reduced	verminderde
perceive	waarnemen
started	gestart
nerve	zenuw
prevention	preventie
remain	blijven
get	krijgen
think	denken
ovulation	ovulatie
lifelong	levenslang
bones	botten
general	algemeen
diaphragm	middenrif
whereby	waarbij
ablation	verwijdering
plan	plannen
against	tegen
alteration	wijziging
cheaper	goedkoper
autonomic	autonoom
statement	verklaring
october	oktober
unit	eenheid
sample	monster
brief	kort
thoughts	gedachten
nuts	noten
keep	aanhouden
reduction	verlaging
yielding	waardoor
insulin	insuline
crystal	kristal
edward	edward
philosophy	filosofie
discussion	discussie
types	types
prize	prijs
hit	raakt
necessitating	noodzakelijk
anteriorly	anterior
needed	benodigde
take	afnemen
taking	nemen
average	gemiddeld
grams	gram
couple	paar
variation	variatie
polycythemia	polycythaemia
monitored	bewaakt
recognition	erkenning
evil	kwaad
face	gelaat
on	inzake
necessity	noodzaak
adjustments	aanpassingen
observed	opgemerkt
save	opslaan
wrote	schreef
operations	verrichtingen
monomania	monomanie
glass	glas
ordinary	gewoon
sentence	zin
ferment	gisten
distal	distale
size	grootte
wounded	gewonden
discontinued	gestaakt
modification	modificatie
history	geschiedenis
staying	verblijven
production	productie
allergic	allergische
outcomes	uitkomsten
specialization	specialisatie
0	0
connected	aangesloten
head	kop
provides	biedt
part	aandeel
factual	feitelijk
upright	rechtop
low	lage
offer	bieden
false	verkeerde
reflux	reflux
increases	verhoogt
acne	acne
underlying	onderliggende
dental	tand
shaped	gevormde
components	onderdelen
supposed	verondersteld
supply	aanvoer
kept	bewaard
file	bestand
losing	verliezen
aorta	aorta
messenger	messenger
penetrates	binnendringt
like	als
stent	stent
complex	complex
peristalsis	peristaltiek
relatively	relatief
dietitian	diëtist
basilar	basilaris
propofol	propofol
base	basis
down	af
place	plaatsgevonden
traction	tractie
eczema	eczeem
string	draad
localized	gelokaliseerd
fillings	vullingen
medications	medicijnen
lesions	laesies
immunology	immunologie
onwards	verder
us	ons
alarm	alarm
podiatrists	podotherapeuten
_	_
indirect	indirecte
effect	effect
ensuring	zorgen
recover	herstellen
wants	wil
shell	omhulsel
limited	beperkt
tnm	tnm
cure	genezen
saved	opgeslagen
home	thuis
y	y
factors	factoren
set	stellen
potter	potter
restore	herstellen
padding	vulling
radioactive	radioactieve
response	antwoord
obvious	duidelijk
fertile	vruchtbaar
permanent	blijvende
solve	oplossen
occurs	optreedt
results	resultaten
venae	venae
advisable	raadzaam
specialize	specialiseren
affected	aangetast
procedures	procedures
researcher	onderzoeker
igg4	igg4
methods	methoden
doctor	dokter
constitute	vormen
donated	gedoneerd
front	voorste
disturbed	gestoord
financial	financiële
differences	verschillen
orbit	oogkas
pink	roze
tumor	gezwel
unclear	onduidelijk
training	opleidingen
hemagglutinin	hemagglutinine
p	p
last	afgelopen
mouth	mond
resist	weerstand
tubular	tubulaire
popliteal	poplitea
was	was
jerks	schokken
scientific	wetenschappelijke
biopsies	biopten
remember	onthouden
apoptosis	apoptose
niyama	niyama
current	huidige
meal	maal
writes	schrijft
also	tevens
deliberately	opzettelijk
defecation	ontlasting
know	weet
take	aannemen
determine	bepalen
penetrate	binnendringen
then	vervolgens
lap	ronde
attain	bereiken
growing	groeiende
environment	milieu
residual	overgebleven
concentrations	concentraties
aids	aids
union	unie
pigment	kleurstof
activity	werkzaamheid
erythema	erythema
meter	meter
tia	tia
herbal	kruiden
100,000	100.000
affect	aantast
etc.	enz
stenoses	vernauwingen
vitreous	glasvocht
made	maakten
2015	2015
sphincter	kringspier
incision	incisie
glomerulonephritis	glomerulonefritis
voluntary	vrijwillig
probable	waarschijnlijke
ingestion	inname
available	beschikbare
mixture	mengsel
framework	kader
worse	erger
combining	combineren
oppositional	tegenovergestelde
well	wel
spain	spanje
particular	bijzonder
mammography	mammografie
formally	formeel
wrong	fout
parietal	pariëtale
live	leven
sought	getracht
decreases	afneemt
der	der
shower	douche
norway	noorwegen
bear	verdragen
acknowledged	erkend
specialized	gespecialiseerd
health	health
partial	partiële
proposed	voorgesteld
:	:
syndromes	syndromen
week	week
contraception	anticonceptie
class	klasse
iii	iii
gingiva	tandvlees
yearly	jaarlijks
modified	gemodificeerde
glasses	bril
infusion	infuus
forage	voer
analgesia	verdoving
exercise	uitoefenen
slowly	langzaam
started	startte
miosis	miose
protection	bescherming
delirium	delier
childbearing	vruchtbare
government	regering
colour	kleur
island	eiland
augment	vergroten
agraphia	agrafie
type	type
device	hulpmiddelen
patients	patiënten
heavy	zwaar
flexed	gebogen
1980	1980
herpes	herpes
remainder	overige
podiatrist	podoloog
aberrant	afwijkend
administration	administration
trouble	moeite
arteriovenous	arterioveneuze
red	rode
e	e
carefully	voorzichtig
high	high
healthcare	gezondheidszorg
break	afbreken
periods	perioden
wax	was
outside	uitwendige
option	keuze
spirometry	spirometrie
toxins	toxines
veins	aders
course	loop
life	levensjaren
injury	letsel
neurologist	neuroloog
hemorrhaging	bloedingen
stopping	stoppen
regularly	regelmatig
offer	aanbod
powers	bevoegdheden
schedules	schema
seen	gezien
detector	detector
hippocrates	hippocrates
study	studie
caused	veroorzaakt
intern	intern
appliances	apparaten
m.	m.
positive	positief
2.5	2,5
recommended	aanbevolen
eyelid	ooglid
freedom	vrijheid
whatever	ongeacht
etc	etc
nnt	nnt
b.	b.
phlebectomy	flebectomie
breakdown	afbreken
states	bepaalt
intestines	darmen
ordered	verwezen
instruments	instrumenten
one	ene
next	volgende
elevation	verhoging
to	toe
refined	gezuiverd
area	gebied
leaves	verlaat
bath	bad
mucous	slijmvliezen
something	iets
being	wezen
alkalosis	alkalose
annual	jaarlijkse
metastasis	uitzaaiing
personality	persoonlijkheid
ventilated	beademd
amnesia	amnesie
pieces	stukjes
infections	besmettingen
further	verder
von	von
looks	kijkt
picture	beeld
anesthesia	anesthesie
protected	beschermd
sex	seks
studying	bestuderen
related	gerelateerde
fifty	vijftig
involved	betrokken
vomit	braken
receptors	receptoren
date	datum
arthritis	artritis
changes	veranderingen
long	lange
formed	gevormde
wider	breder
flap	klep
normally	gewoonlijk
group	groep
concluded	gesloten
know	kennen
greek	griekse
leukodystrophy	leukodystrofie
supporters	voorstanders
making	aanmaak
problematic	problematisch
pulse	pols
losses	verliezen
8	8
color	kleuren
previously	eerder
ranula	ranula
control	controle
committee	committee
metabolic	metabole
sharp	scherp
conventional	conventionele
dozens	tientallen
colonic	colon
actual	daadwerkelijk
testing	testen
seated	zittende
negative	negatieve
detection	detectie
registration	registratie
developed	ontwikkelde
eicosapentaenoic	eicosapentaeenzuur
e.g.	b.v.
society	samenleving
natural	natuurlijk
syndrome	syndroom
introduction	invoering
are	bent
anxieties	angsten
lay	leggen
contraindications	contra-indicaties
cava	cava
diarrhea	diarree
phases	fasen
wait	wachten
version	versie
available	beschikbaar
rectum	endeldarm
exterior	buitenkant
drum	trommel
laryngoscope	laryngoscoop
anesthesia	verdoving
highest	hoogst
specially	speciaal
finally	slotte
prior	voorafgaand
performed	uitgevoerd
together	samen
encounter	ondervinden
increasing	toenemende
fourth	vierde
operation	ingreep
therapy	therapie
occur	voordoen
chordates	chordadieren
corneal	hoornvlies
playing	spelen
sign	teken
amenable	vatbaar
accused	verdachte
just	gewoon
create	aanmaken
definite	definitief
therefore	derhalve
iud	spiraaltje
third	derde
degradation	afbraak
1847	1847
transport	vervoeren
report	melden
enlarged	vergrote
solely	alleen
component	bestanddeel
added	toegevoegd
fatal	fatale
haploid	haploïde
stories	verhalen
often	dikwijls
swallow	slikken
ultrasonography	echografie
inhalation	inademing
inflammation	ontsteking
gastric	gastric
oocytes	oöcyten
facelift	facelift
21	21
business	bedrijf
record	opnemen
operation	operatie
treated	behandeld
neck	nek
supply	toevoer
appointment	afspraak
bound	gebonden
iv	iv
adverse	nadelige
migrating	migreren
hemorrhages	bloedingen
immunity	immuniteit
layer	laag
take	innemen
adrenaline	adrenaline
fire	brand
units	eenheden
construct	opbouwen
toxic	giftige
flu	griep
complication	complicatie
significance	betekenis
six	zes
assistance	begeleiding
it	ermee
examining	onderzoeken
veins	venen
2003	2003
range	scala
reticulum	netmaag
separation	scheiding
lupus	lupus
entails	inhoudt
restoration	restauratie
hair	haar
side	zijde
return	terugkomen
saphenous	vena
known	bekend
withdrawn	onttrokken
chamber	oogkamer
wound	wonden
absolute	absoluut
family	familie
entrance	ingang
rupture	scheuring
ducts	leidingen
1-2	1-2
rising	stijgende
send	sturen
intercourse	omgang
factitious	kunstmatig
portion	deel
checking	controleren
seriously	ernstig
silent	stil
ask	vragen
considerable	aanzienlijk
register	registreren
ever	steeds
diarrhoea	diarree
thrombolysis	trombolyse
igg	igg
candidiasis	candidiasis
viruses	virussen
covers	beslaat
dizziness	duizeligheid
reinforced	versterkte
500	500
unless	tenzij
anaphylaxis	anafylaxie
attempts	probeert
breast	borst
thrombocytopenia	trombocytopenie
sternal	borstbeen
resident	aios
awarded	uitgereikt
polydipsia	polydipsie
division	indeling
serologic	serologische
chronic	chronisch
w.	w.
claudication	etalagebenen
drops	zakt
because	omdat
ache	pijn
cardiovascular	cardiovasculaire
coming	komst
written	geschreven
depends	hangt
points	wijst
receiver	ontvanger
agglutination	agglutinatie
awake	wakker
half	half
call	noemen
contributors	medewerkers
anomaly	afwijking
character	karakter
inspiration	inspiratie
palate	gehemelte
sites	plekken
europe	europa
,	,
antigens	antigenen
the	de
addressed	aangepakt
lives	leeft
sleep	slaap
cytoplasmic	cytoplasma
infect	infecteren
fed	gevoed
heparin	heparine
news	nieuws
nerve	nervus
breastmilk	moedermelk
a	één
clues	aanwijzingen
ground	grond
clubhouse	clubhuis
slowing	vertragen
effects	gevolgen
immediately	onmiddellijk
released	vrijkomt
shunt	shunt
emergency	spoedeisende
lower	zakken
physical	lichamelijke
cancer	kanker
maintain	handhaven
release	loslaten
c.	c.
chemical	chemische
plague	pest
plane	vlak
feeling	gevoel
stone	niersteen
time	keer
doing	doen
operational	operatief
amended	gewijzigd
mapping	indeling
lt	lt
powered	aangedreven
difficulties	moeilijkheden
below	beneden
randomly	willekeurig
detected	opgespoord
story	verhaal
sensitivity	gevoeligheid
others	anderen
appearance	optreden
deleterious	schadelijk
infectivity	besmettelijkheid
laboratory	laboratorium
tumor	tumor
gallbladder	galblaas
o	o
sore	zeer
intervene	ingrijpen
supply	leveren
were	waren
oas	oas
personal	persoonlijke
demand	vraag
neurologic	neurologisch
appearance	uiterlijk
pill	pil
year	jaar
recur	terugkeren
wards	afdelingen
often	veelal
impacted	beïnvloed
myasthenia	myasthenia
toothpaste	tandpasta
potential	potentiële
exist	bestaan
leaf	blad
surveillance	bewaking
from	vanuit
viral	virale
ulcerated	zweren
clinical	clinical
characteristics	kenmerken
direct	rechtstreekse
vulnerable	kwetsbaar
citizens	burgers
arteriosclerosis	arteriosclerose
maximum	maximale
emphasize	benadrukken
intercourse	geslachtsgemeenschap
walls	wanden
resolved	opgelost
result	uitkomst
selective	selectief
troublesome	lastig
deep	diep
hole	gat
unsaturated	onverzadigde
cartilage	kraakbeen
green	groen
facial	facialis
encouraged	gestimuleerd
magnification	vergroting
meal	maaltijd
concentration	concentratie
anomalies	afwijkingen
interference	interferentie
only	pas
soft	zacht
aneurysms	aneurysmata
conservation	gesprek
weeks	weken
needle	naald
devices	apparaten
easy	makkelijk
minor	minor
injected	ingespoten
pus	etter
artificially	kunstmatig
reverse	omgekeerde
indicates	duidt
erythrocyte	erytrocyten
acceptable	aanvaardbare
original	oorspronkelijke
family	gezin
paris	parijs
array	reeks
intensive	intensief
other	ander
so	dus
as	naargelang
anatomical	anatomisch
fats	vetten
world	wereld
posture	houding
gills	kieuwen
neglect	verwaarlozing
gait	gang
cultured	ontwikkeld
polyps	poliepen
wait	wacht
podiatrist	podotherapeut
visual	zichtbaar
diep	diep
1988	1988
1,000	1000
coming	komt
mattress	matras
america	amerika
increase	verhogen
increase	verhoging
cph	cph
each	ieder
barber	barbier
dangerous	levensgevaarlijk
pain	pijn
dishwasher	afwasmachine
disappears	verdwijnt
edge	rand
alive	levend
etc	enz
originates	afkomstig
help	helpen
vertebrae	wervels
clones	klonen
region	regio
strength	kracht
efficacy	werkzaamheid
infected	geïnfecteerd
highly	zeer
n.	n.
symptoms	symptomen
wash	afwassen
organizations	organisaties
confer	verlenen
metabolism	metabolisme
frequently	frequent
skull	schedel
frontal	frontale
rises	stijgt
director	directeur
synapses	synapsen
vertebrates	gewervelden
footwear	schoeisel
sperm	spermacel
+	+
identify	identificeren
excreted	uitgescheiden
airway	luchtweg
fasciculations	fasciculaties
periods	periodes
comparing	vergelijken
inhale	inademen
special	bijzonder
town	gemeente
foramen	foramen
endothelium	endotheel
symptomatic	symptomatische
numbness	verdoving
coma	coma
discuss	bespreken
uncomplicated	eenvoudig
apnea	apneu
cytoplasm	cytoplasma
battle	strijd
almost	bijna
one	een
avoid	vermijden
helium	helium
succeeded	geslaagd
serious	ernstige
college	college
damage	beschadiging
day	dag
dyskinesia	dyskinesie
vitamins	vitamines
at	bij
month	maand
impetigo	impetigo
university	academisch
variant	variant
increased	verhoogd
degree	mate
people	personen
dialysis	dialyse
extremity	uiteinde
status	toestand
disturbance	stoornis
20	20
april	april
janet	janet
words	woorden
diverse	verschillend
voice	stem
remember	herinneren
documents	documenten
calculating	berekenen
thinning	verdunnen
supporting	ondersteunende
remarkable	opvallende
practically	bijna
larva	larve
blueprint	plan
injected	geïnjecteerd
uses	hanteert
pregnancies	zwangerschappen
plays	speelt
previous	voorgaande
self	zelf
management	management
patient	patient
satisfy	voldoen
progressive	progressieve
print	gedrukt
nephrolithiasis	nierstenen
dispersed	verspreid
angioplasty	angioplastiek
years	jaar
antidote	tegengif
dealing	bezighoudt
surveillance	toezicht
haemoglobin	hemoglobine
scientists	wetenschappers
values	waarden
back	achterkant
nystagmus	nystagmus
killing	doodt
consult	raadplegen
neuromuscular	neuromusculaire
gynaecology	gynaecologie
correction	correctie
representation	voorstelling
music	muziek
animals	dieren
antiquity	oudheid
obstructive	obstructieve
primary	voornaamste
incorrectly	onjuist
mid	midden
narrative	narratieve
eye	oog
dyspnea	kortademigheid
help	behulp
valve	klep
cecum	blindedarm
1970s	1970
parkinson	parkinson
allergen	allergeen
articulator	gewricht
stand	stand
volunteers	vrijwilligers
wound	wond
c2	c2
process	verwerken
before	voor
forces	krachten
next	volgend
leukocytes	leukocyten
skeleton	skelet
characteristic	karakteristieke
parkinsonian	parkinson
clinical	klinisch
university	universiteit
drawn	getrokken
navel	navel
anaemia	anemie
last	duren
meant	bedoelde
training	opleiding
healthy	gezond
50	50
peripheral	perifere
antibodies	antilichamen
surface	oppervlak
a	een
surgeons	chirurgen
ecthyma	ecthyma
uterus	uterus
equal	gelijk
concepts	begrippen
ascites	ascites
act	handeling
la	la
angiogenesis	angiogenese
impairment	verslechtering
lasting	durende
become	worden
affinity	affiniteit
inhibits	remt
amniotic	vruchtwater
fluids	vloeistoffen
although	weliswaar
standard	standard
see	zien
extensive	uitgebreid
person	persoon
sessions	sessies
sneezing	niezen
growth	groei
spot	plek
exogenous	exogene
percentage	percentage
zoonosis	zoönose
poisoning	vergiftiging
quite	heel
main	hoofd
fewer	minder
dies	afsterft
strict	strenge
insurance	verzekering
try	trachten
reinforces	versterkt
varicose	spataderen
best-known	bekendste
interesting	interessant
acidic	zure
bigger	groter
allergy	allergie
short	kortdurende
power	kracht
aperture	opening
arrhythmias	hartritmestoornissen
federation	federatie
demands	eisen
ill	ziek
surgery	heelkunde
psychotherapy	psychotherapie
attention	aandacht
bee	bij
dust	stof
answers	antwoorden
flies	vliegen
begun	begonnen
nurse	verpleegkunde
aid	hulpverlening
expensive	duurder
fields	velden
extension	uitbreiding
september	september
citrate	citraat
cooking	koken
work	werk
security	veiligheidsmaatregelen
wait	wachttijd
lifestyle	levensstijl
bacteria	bacterie
29	29
candida	candida
burp	boeren
fractured	gebroken
to	om
wall	wand
infant	zuigeling
affected	getroffen
heard	gehoord
nephrectomy	nefrectomie
adequately	adequaat
population	bevolking
lateral	laterale
compartment	gedeelte
state	staat
nations	landen
biliary	galwegen
restriction	beperking
distinguish	onderscheiden
costs	kosten
actively	actief
cerebral	cerebrale
based	gebaseerd
28	28
narrowing	vernauwing
jan	januari
colitis	colitis
–	-
dog	hond
balance	evenwicht
sonic	sonische
enhanced	versterkte
launched	opgezet
permanent	permanente
aminoglycosides	aminoglycosiden
existed	bestond
elderly	oudere
trying	proberen
only	slechts
true	ware
aneurysmal	aneurysma
deficits	uitvalsverschijnselen
unusually	ongewoon
sight	zicht
filling	vulling
ingesting	inname
pictures	plaatjes
ureter	urineleider
noted	bekend
speak	spreken
had	had
flow	stromen
ingredients	ingrediënten
funding	financiering
professor	professor
pta	pta
anywhere	overal
youth	jeugd
metastasis	metastasering
flow	flow
meets	voldoet
7	7
aims	streeft
international	international
set	voorgeschreven
misuse	misbruik
error	fout
warm	warm
measurement	meet
chinese	chinese
cold	kou
sepsis	sepsis
conscious	bewuste
carl	carl
enormous	enorme
employ	dienst
recommends	raadt
stream	stroom
malignancy	maligniteit
dealt	behandeld
pathogens	ziekteverwekkers
bright	felle
d-dimer	d-dimeer
careful	voorzichtig
commercial	commercieel
literature	literatuur
commonly	algemeen
intervention	interventie
dissolved	opgelost
more	grotere
rinsing	spoelen
early	vroegtijdig
retardation	retardatie
fragrance	geur
jaws	bek
required	nodig
stone	steen
follow	volgen
chlorine	chloor
accurately	nauwkeurig
pain	pijnklachten
done	geschiedt
eeg	eeg
product	artikel
lifted	opgeheven
operculum	operculum
2	2
chains	ketens
project	project
enhance	verbeteren
assist	helpen
set	stel
alveolar	alveolaire
150	150
own	bezitten
successive	opeenvolgende
hospital	ziekenhuiszorg
drinks	dranken
breathing	ademhaling
grown	gegroeid
dro	dro
recognised	erkend
selectively	selectief
activating	activeren
happen	gebeuren
used	gebruikgemaakt
blocked	geblokkeerd
variola	variola
urge	drang
respiratory	luchtwegen
alter	wijzigen
inlay	inlay
transmissible	overdraagbaar
expression	uiting
dha	dha
benefit	voordeel
regulations	regelgeving
elevated	verhoogd
upon	op
additional	bijkomend
functionally	functioneel
researches	onderzoeken
forearm	onderarm
meaning	betekenis
locally	plaatselijk
frequent	veelvoorkomende
genetically	genetisch
royal	koninklijke
habit	gewoonte
contribute	bijdragen
snoring	snurken
exposure	blootstelling
weakened	verzwakt
reduction	reductie
transferred	overgedragen
blow	blazen
conception	opvatting
periodically	periodiek
molecules	moleculen
film	film
left	gelaten
embryo	embryo
removed	verwijderd
undergoing	ondergaat
session	sessie
death	dood
insomnia	slapeloosheid
they	zij
buttocks	billen
helped	geholpen
physician	arts
change	wijziging
drug	farmacon
gather	verzamelen
draw	putten
injection	injectie
sized	grootte
rests	berust
suddenly	plotseling
copd	copd
most	grootst
institution	instelling
microcephaly	microcefalie
auras	aura
expired	verlopen
level	niveau
veterinary	veterinaire
educated	geleerd
light	licht
increase	toename
face-lifting	facelift
just	juist
conduit	leiding
addictive	verslavend
clean	reinigen
glans	eikel
differs	verschilt
post	post
cancer	kankercellen
2010	2010
d	d
gases	gassen
following	volgend
acquire	verkrijgen
supplementation	suppletie
numbers	aantallen
rich	rijk
metamorphosis	metamorfose
such	dergelijke
vein	vene
degrees	graden
establish	vaststellen
anaphylactic	anafylactische
chin	kin
occurring	voorkomend
coloration	kleur
the	het
reduction	vermindering
nephrotic	nefrotisch
norm	norm
english	engelse
undergoes	ondergaat
women	vrouw
differently	anders
gradual	geleidelijk
exclusion	uitsluiting
lavender	lavendel
dropped	gedaald
karl	karl
vapor	dampen
born	geboren
stroke	herseninfarct
event	gebeurtenis
rna	rna
barbiturates	barbituraten
metal	metalen
applied	toegepaste
varies	varieert
ambient	omringende
connection	aansluiting
mammals	zoogdieren
traditional	traditioneel
hit	raken
put	gezet
protein	proteïne
period	periode
to	aan
coordination	coördinatie
headache	hoofdpijn
particularly	vooral
consciousness	bewustzijn
toes	tenen
losses	liezen
matrix	voedingsbodem
diagnose	diagnosticeren
glycosuria	glucosurie
ward	afdeling
gene	gen
blocking	blokkeren
chain	keten
t.	t.
human	human
bleed	bloeden
this	hiervoor
loads	massa
metallic	metalen
processed	verwerkt
activities	activiteiten
soon	spoedig
transcortical	transcorticale
full	volledig
ingested	ingeslikt
traits	eigenschappen
signs	tekenen
got	kregen
seem	lijken
diuretics	diuretica
programme	programma
weakening	verzwakking
glass	glazen
itself	vanzelf
directed	gericht
survive	overleven
features	kenmerkt
damaged	beschadigde
special	speciaal
twelve	twaalf
abortion	abortus
ringworm	ringworm
apply	geldt
chemotherapy	chemotherapie
correct	corrigeren
stronger	sterkere
certain	bepaald
process	werkwijze
adhd	adhd
clothes	kleren
wrong	mankeert
response	respons
life-threatening	levensbedreigende
bálint	bálint
million	miljoen
more	vaker
dangerous	gevaarlijk
ingredients	bestanddelen
lifetime	levenslang
chlamydia	chlamydia
deletion	deletie
disease	disease
knee	knie
church	kerk
irritation	irritatie
stings	steken
science	kunde
connection	verbinding
notion	begrip
removal	verwijdering
decide	uitmaken
prostate	prostaat
continuous	continue
lots	veel
ix	ix
lightly	licht
algae	algen
rather	liever
pulls	trekt
40	40
anterior	anterior
brand	merknaam
ibuprofen	ibuprofen
impossible	onmogelijk
legs	benen
proteins	proteïnen
basis	grondslag
27	27
pigment	pigment
organic	organisch
ring	ring
staff	personeel
cerebellum	cerebellum
fight	strijd
inconvenient	lastig
opinions	adviezen
intractable	hardnekkige
rapidly	snel
suitable	geschikte
foods	voedingsmiddelen
tube	slangetje
infertile	onvruchtbaar
number	getal
infarct	infarct
acutely	acuut
open	open
anaerobic	anaerobe
subarachnoid	subarachnoïdale
simple	simpel
artificial	kunstmatig
practice	praktijk
enormous	enorm
shorter	korter
prolonged	langdurig
nerves	zenuwbanen
diffuse	diffuse
anesthetic	anestheticum
extremely	uitermate
parasites	parasieten
enlargement	uitbreiding
chewing	kauwen
cerebri	cerebri
vertebral	wervel
tuberculosis	tuberculosis
bill	rekening
link	koppeling
conversation	gesprek
here	hier
decades	decennia
demand	vragen
employs	gebruikt
named	noemde
sternum	borstbeen
act	act
guided	begeleid
turn	keren
ministry	ministerie
irritability	prikkelbaarheid
hereditary	erfelijk
aura	aura
indicate	duiden
drowsiness	slaperigheid
thrombophilia	trombofilie
limit	beperken
lost	kwijt
peg	peg
we	wij
medically	medisch
nails	nagels
terbinafine	terbinafine
fixed	vastgezet
handle	omgaan
pelvis	bekken
detect	opsporen
examines	bestudeert
leg	been
self-healing	zelfgenezend
from	vandaan
true	waar
thinner	thinner
creatinine	creatinine
copper	koper
household	huishoudelijke
1-3	1-3
resuscitation	reanimatie
orthodontic	orthodontische
cold	koud
existence	bestaan
lower	lager
emphasis	nadruk
definitive	definitief
poison	gif
identified	aangemerkt
disorders	stoornissen
step	treden
electrodes	elektroden
neurons	zenuwcellen
corrected	gecorrigeerd
outbreak	uitbraak
diploid	diploïde
situations	situaties
spores	sporen
fairly	tamelijk
tried	geprobeerd
all	helemaal
disease	ziektebeeld
inheritance	vererving
x-ray	röntgenfoto
originating	oorsprong
purpura	purpura
advised	adviseerde
ahc	ahc
section	doorsnede
predict	voorspellen
urinary	urine
thrombocytosis	trombocytose
ordinarily	gewoonlijk
free	vrij
formation	vorming
assay	analyse
outermost	buitenste
specifications	bestek
little	kleine
tube	buis
disadvantages	nadelen
supplemented	aangevuld
femoral	femoralis
anuria	anurie
mange	schurft
infection	infectie
duodenum	duodenum
flowing	stromen
infected	besmet
bleeding	bloedingen
score	scoren
conversely	omgekeerd
factor	factor
hand	hand
current	lopende
they	ze
emotion	emotie
most	meeste
undiagnosed	gediagnosticeerd
doctor	arts
retain	behouden
india	india
limitations	beperkingen
employees	werknemers
understands	begrijpt
under	onder
david	david
sterile	steriele
ernst	ernst
let	laat
adaptations	aanpassingen
smallpox	pokken
pustules	pustels
circulation	circulatie
powerful	krachtig
coli	coli
joint	gezamenlijke
contained	bevatte
&	&
received	gekregen
height	hoogte
fall	afvallen
aspect	aspect
worsen	verergeren
vary	variëren
pituitary	hypofyse
primary	primaire
feces	ontlasting
broken	gebroken
triggered	veroorzaakt
similarities	overeenkomsten
lidocaine	lidocaïne
hypothalamic	hypothalamus
measures	maatregelen
immune	immuunreactie
instance	aanleg
artery	arterie
long-lasting	langdurig
add	toevoegen
goal	doel
artificial	kunstmatige
microscopically	microscopisch
completed	afgerond
conditions	conditie
lichen	lichen
folic	foliumzuur
insufficiency	insufficiëntie
come	komen
maximum	maximum
acid	zuur
use	gebruik
needed	nodig
humoral	humorale
especially	vooral
fortified	versterkte
fertility	vruchtbaarheid
named	vernoemd
typically	typisch
persons	personen
cues	signalen
vein	ader
list	lijst
sound	degelijk
publicity	bekendheid
obstruction	obstructie
restored	hersteld
may	mei
oxygen	zuurstofarm
folk	mensen
superior	superior
composite	samenstelling
breaks	breekt
stoma	stoma
st	st
antimicrobial	antimicrobiële
although	hoewel
diminish	verminderen
autonomous	autonome
ash	as
incorporates	bevat
middle	midden
costs	kost
right	correct
members	leden
again	weer
part	uitmaakt
concerned	desbetreffende
function	functie
constantly	voortdurend
register	register
influence	beïnvloeden
far	ver
spread	verspreiden
posterior	posterior
cities	steden
results	resulteert
abnormally	abnormaal
on	erop
branch	tak
affected	aangetaste
antibiotic	antibioticum
vagina	vagina
watched	bekeken
secondary	tweede
reticulum	reticulum
wearers	dragers
blood	bloedvoorziening
approved	aangenomen
activated	geactiveerd
assistive	ondersteunende
noninvasive	niet-invasieve
eyelids	oogleden
producers	producenten
obtaining	verkrijgen
prove	aantonen
american	american
tension-type	spanningshoofdpijn
abbreviated	afgekort
shock	shock
appearing	verschijnen
dri	dri
compensated	vergoed
needing	hoeven
convinced	overtuigd
combinations	combinaties
immobilization	immobilisatie
leakage	lekkage
initial	aanvankelijk
embolism	embolie
€	€
concentrating	concentreren
physicians	artsen
main	belangrijkste
rinse	spoelen
beverages	dranken
some	zekere
insured	verzekerde
available	verkrijgbaar
all	alle
ensuing	volgend
podiatry	podotherapie
5000	5000
nerve	zenuwbaan
plural	meervoud
violent	hevig
bleaching	bleken
spectacles	bril
calluses	eelt
yield	opleveren
1997	1997
patient	zieke
functional	functioneel
it	daaraan
youth	jongeren
internationally	internationaal
draws	trekt
carcinogen	kankerverwekkend
shaking	schudden
menstruation	menstruatie
official	officiële
dead	dode
down	omlaag
tibial	tibiale
take	nemen
specific	specifieke
anatomic	anatomische
flows	stroomt
aiming	streven
early	vroege
firmly	stevig
prothrombin	protrombine
outcome	outcome
field	veld
delivered	geleverd
sodium	natrium
beating	kloppende
available	voorhanden
again	opnieuw
reduced	verlaagd
prove	blijken
till	tot
basis	basis
some	enige
alternatively	alternatief
vaccinated	gevaccineerd
licensed	erkend
professional	beroepsmatige
designation	aanwijzing
70	70
urethra	urethra
precisely	precies
moreover	overigens
must	moesten
provides	voorziet
combination	combinatie
animal	dierlijke
excessive	overmatig
length	lengte
dominant	dominante
prepared	bereid
tea	thee
shape	vorm
replaced	vervangen
word	woord
mean	bedoelt
larvae	larven
benzodiazepines	benzodiazepines
products	producten
vascular	vasculaire
chromatin	chromatine
encephalopathy	encefalopathie
pratyahara	pratyahara
outlook	vooruitzichten
emotions	emoties
mendel	mendel
realize	realiseren
benefit	behoeve
bfs	bfs
person	betrokkene
gaf	gaf
pieces	stukken
accounted	goed
fault	fout
shaped	gevormd
catching	vangen
200	200
spray	spray
contributed	ingebracht
bacteriuria	bacteriurie
overall	algehele
feed	voeren
originating	afkomstig
intrinsic	intrinsic
defense	afweer
program	programma
amphetamine	amfetamine
hiccups	hik
strength	sterkte
simple	eenvoudige
larger	grotere
constituent	bestanddeel
fda	fda
conducted	uitgevoerd
looked	gekeken
foodstuffs	levensmiddelen
85	85
pharynx	keelholte
thickness	dikte
associated	geassocieerd
gps	huisartsen
groin	lies
choice	keuze
conversion	omzetting
emitted	uitgestoten
essential	essentieel
and	én
drills	bedrijfshulpverlening
dr.	dr.
perforation	perforatie
definitely	definitief
discussed	besproken
extent	omvang
determination	bepaling
caesarean	keizersnede
tablets	tabletten
rising	opstijgende
heart	hart
ulcer	ulcus
top	top
tingling	tintelingen
notable	opvallend
has	heeft
stable	stabiel
dag	dag
—	-
hemophilia	hemofilie
lower	dieper
is	bedraagt
surrounding	omliggende
additional	aanvullende
mg	mg
ketonuria	ketonurie
both	zowel
vacuum	vacuüm
catheter	katheter
could	kon
impulses	impulsen
around	rond
benefits	voordelen
worse	slechtere
fluid	vloeistof
sensitivity	sensitiviteit
electric	elektrisch
coughs	hoest
additionally	bovendien
measured	gemeten
expert	deskundige
heat	warmte
knife	mesje
fight	bestrijding
trial	proces
chance	kans
contacts	contacten
mixed	vermengd
featured	aanbevolen
ultrasound	echografie
propagation	voortplanting
abdomen	buik
opportunities	mogelijkheden
psychological	psychologisch
circumstances	omstandigheden
human	menselijk
arisen	ontstane
cosmetics	cosmetica
0.8	0,8
dilate	verwijden
woman	vrouw
did	deed
extreme	uiterste
stay	blijven
bleeding	bloeding
digestion	vertering
chemistry	chemie
burns	brandwonden
neurological	neurologische
zoonoses	zoönosen
tourniquet	tourniquet
canada	canada
latin	latijnse
and	en
healing	genezing
consist	bestaat
neglect	neglect
endothelial	endotheel
globally	wereldwijd
monitoring	controle
components	componenten
component	component
intestine	darm
amputation	amputatie
likely	aannemelijk
elderly	bejaarden
awarded	toegekend
plasmin	plasmine
drain	drain
medicine	geneeskunde
ruptured	gescheurde
falls	valt
spots	vlekken
cognition	kennis
adapting	aanpassen
western	westerse
norms	normen
surgically	operatief
distribute	verdelen
minute	minuut
possibly	mogelijk
develops	ontwikkelt
genes	genen
waves	golven
optical	optische
negative	negatief
emg	emg
suppressed	onderdrukt
mushrooms	paddenstoelen
endogenous	endogene
order	orde
certain	zeker
artery	artery
attempts	pogingen
erythropoietin	erytropoëtine
comorbidity	comorbiditeit
result	resulteren
likely	waarschijnlijk
outpatient	ambulante
works	werken
individuals	individuen
belgium	belgië
wrong	verkeerd
pharmacopoeia	farmacopee
etc.	etc.
military	soldaten
constraint	beperking
repeat	herhalen
discern	onderscheiden
recorded	vastgelegd
mutation	mutatie
related	verwante
laparoscopy	laparoscopie
rates	tarieven
operations	operaties
agitated	bewogen
hypothalamus	hypothalamus
capabilities	mogelijkheden
legs	poten
language	taal
value	waarde
expanded	uitgebreid
acidity	zuurgraad
maximum	maximaal
attempt	poging
idea	idee
cause	oorzaak
pharmacopoeias	farmacopee
abuse	misbruik
thoroughly	grondig
satisfied	voldaan
briefly	kort
generic	algemeen
stood	stond
mandible	onderkaak
suture	hechten
scottish	schotse
g	g
connective	bindweefsel
false	onjuist
french	frans
medica	medica
antidepressants	antidepressiva
match	overeen
bladder	blaas
ed	ed
live	levende
responds	reageert
frogs	kikkers
opened	geopend
collagen	collageen
shortage	schaarste
affected	aangedaan
responsibility	verantwoordelijkheid
duty	dienst
preventing	voorkomen
lot	flink
everywhere	overal
;	;
thrombosis	trombose
back	terug
treatments	behandelingen
carbohydrates	koolhydraten
circulation	bloedcirculatie
thirty	dertig
moderately	matig
root	wortel
administering	toedienen
mean	gemiddelde
hemoptysis	bloedspuwing
behavior	gedragsproblemen
november	november
lma	larynxmasker
isoforms	isovormen
she	ze
had	hadden
via	via
foreskin	voorhuid
environmental	milieu
rubbing	wrijven
granulocytes	granulocyten
choking	verslikken
comorbidities	comorbiditeit
bloodflow	bloedstroom
runs	loopt
test	test
maxillary	kaak
suffers	lijdt
parasitic	parasitaire
encourages	stimuleert
coping	omgaan
seven	zeven
dies	overlijdt
-	--
necessarily	nodig
former	voormalige
fungi	schimmels
lems	lems
scholar	geleerde
reducing	vermindering
surroundings	omgeving
dhāraṇā	dharana
streptococcus	streptococcus
tuberculin	tuberculine
understood	begrepen
insights	inzichten
difficult	moeilijk
concentrated	geconcentreerd
residues	resten
temperature	temperatuur
openehr	openehr
spreading	verspreidt
prick	prikken
malignant	maligne
infecting	infecteren
plastic	kunststof
actually	werkelijk
experimental	experimenteel
shock	schok
aimed	gericht
cochlea	slak
those	degenen
registered	geregistreerd
finger	vinger
childbed	kraambed
illegal	illegale
incontinence	urineverlies
amnesia	geheugenverlies
k	k
defence	defensie
als	als
shower	douchen
penicillin	penicilline
iuds	spiraaltjes
poorly	slecht
herself	zichzelf
rinderpest	runderpest
emerging	opkomende
infrequent	zeldzaam
biological	biologisch
spontaneous	spontaan
collecting	verzamelen
die	sterven
beyond	verderop
1994	1994
most	vaakst
plaque	plaque
opening	opening
everyone	iedereen
articular	articulaire
causes	oorzaken
last	laatste
used	aangewend
fluoride	fluoride
serum	serum
express	uiten
atrium	atrium
grasped	begrepen
beginning	begin
should	dient
independent	zelfstandige
water	water
congenital	congenitale
but	maar
converted	omgezet
overload	overbelasting
sex	geslacht
security	veiligheid
suffering	lijden
arterial	arteriële
ph	ph
becoming	worden
matter	materie
supported	ondersteund
reversible	reversibel
phenomena	verschijnselen
considerable	aanmerkelijk
different	verschillend
investigators	onderzoekers
conducted	verricht
some	sommigen
digest	verteren
contents	inhoud
understanding	begrip
4.5	4,5
azoospermia	azoöspermie
fast	snel
perceived	waargenomen
food	food
precursor	voorloper
sentences	zinnen
easier	gemakkelijker
meaningful	belangrijk
prime	eerste
retrieve	terugvinden
organs	organen
learned	geleerd
restrictions	beperkingen
liquid	vloeistof
simultaneously	gelijktijdig
master	master
vesicles	blaasjes
unpleasant	onaangenaam
january	januari
respect	aanzien
every	elk
electrically	elektrisch
neck	hals
bacillus	bacil
remaining	overgebleven
36	36
trauma	trauma
disease	aandoening
doctors	artsen
turn	beurt
circulation	doorbloeding
period	menstruatie
proponents	voorstanders
element	element
enzymes	enzymen
abnormality	afwijking
defects	gebrek
thus	dus
epidural	ruggenprik
burden	last
reliably	betrouwbaar
45	45
overdose	overdosis
rose	nam
young	jonge
wife	vrouw
agenda	agenda
repeat	herhaling
nursing	verpleging
diagnoses	diagnoses
allergens	allergenen
james	james
dead	dood
functioning	functionerend
mirena	mirena
drying	drogen
urethra	plasbuis
swiss	zwitserse
proteins	eiwitten
physiologically	fysiologisch
request	verzoek
origin	herkomst
investigated	onderzocht
artery	arteria
drugs	drugs
rebound	rebound
levels	niveaus
supplementary	aanvullend
cyanosis	cyanose
definitively	definitief
distinguishes	onderscheidt
vaccination	vaccinatie
characteristically	typisch
consuming	consumeren
regular	regelmatig
vertebra	wervel
supervised	toezicht
department	afdeling
beats	klopt
rhythmic	ritmisch
threshold	drempel
coordinated	gecoördineerd
ischemia	ischemie
life	life
himself	zich
change	veranderen
medicine	medicament
liter	liter
removing	verwijderen
hyperventilation	hyperventilatie
muscle	spiermassa
secure	fixeren
object	voorwerp
quantity	hoeveelheid
restricting	beperken
diabetics	diabeten
mistaken	verkeerd
cla	cla
regional	regionaal
ancient	oude
each	telkens
technical	technisch
first	eerst
adapt	aanpassen
accelerate	versnellen
through	middels
hot	warme
accident	ongeval
terminates	eindigt
happens	gebeurt
ductus	ductus
create	aanmaakt
stresses	spanningen
externa	externa
strict	strikt
thrombin	trombine
thorough	grondig
majority	meerderheid
forehead	voorhoofd
1995	1995
inferior	inferior
interrupted	onderbroken
ventricle	ventrikel
consists	bestaat
bark	schors
confirm	bevestigen
u	u
hemoglobin	hemoglobine
itchy	jeukende
across	over
blue	blauwe
voluntarily	vrijwillig
himself	zichzelf
lake	meer
insurance	verzekeringsplicht
classically	klassiek
pressures	druk
wide	breed
situation	situatie
cough	hoest
awareness	voorlichting
transfusion	transfusie
introduction	introductie
female	vrouw
13th	13e
medication	medicatie
impairing	aantasten
national	nationale
untreated	onbehandeld
platform	platform
mechanism	mechanisme
clubhouses	clubhuizen
find	bevinden
experiences	ervaringen
centrally	centraal
chronic	chronische
indications	indicaties
non	niet
happened	gebeurde
along	langs
individual	individu
dyes	kleurstoffen
spring	ontspringen
clumping	samenklontering
urinating	urineren
mechanically	mechanisch
leprosy	lepra
motor	motorische
farming	landbouw
all	hele
diabetic	diabetische
directive	richtlijn
seal	afsluiting
fusion	fusie
flex	buigen
nucleotides	nucleotiden
headaches	hoofdpijn
demonstrated	aangetoond
contain	bevatten
accident	ongeluk
constipation	verstopping
pertaining	behorende
destroyed	vernietigd
gift	donatie
background	achtergrond
athletes	atleten
maxilla	kaak
bright	helder
moreover	bovendien
need	behoeft
scale	schaal
pictures	afbeeldingen
approximately	ongeveer
electrical	elektrische
distribution	verdeling
personally	persoonlijk
infection	besmetting
co	mede
washing	wassen
up	liefst
or	of
forms	vormt
unlikely	onwaarschijnlijk
relation	betrekking
thrombophilias	trombofilie
prescription	voorschrift
hallucination	hallucinatie
additional	bijkomende
fellowship	gemeenschap
disasters	rampen
priority	prioriteit
very	erg
operated	geopereerd
kidney	nier
carcinogenic	kankerverwekkend
both	beiden
decreases	verlaagt
scales	balans
prevalence	prevalentie
less	minder
knowledge	kennis
and	alsmede
violence	geweld
sarcoidosis	sarcoïdose
oil	oliën
centre	centrum
gonorrhea	gonorroe
power	vermogens
oral	orale
above	boven
elisa	elisa
translated	vertaald
welfare	welzijn
collaboration	samenwerking
brought	gebracht
instability	instabiliteit
need	hoeft
geneticists	genetici
body	body
alongside	naast
bumps	bultjes
appeal	beroep
created	aangemaakte
random	toevallig
who	wie
fracture	botbreuk
22	22
protocol	protocol
hard	hard
pacing	stappen
largely	grotendeels
radiotherapy	radiotherapie
gave	gaf
thus	aldus
bend	buigen
sounds	geluiden
cold	koude
surgeries	operaties
series	serie
drop	druppel
returning	terugkerende
pupillary	pupil
treat	behandelen
found	gevonden
best	best
excessive	excessief
doctors	dokters
find	treft
exertion	inspanning
prostheses	prothesen
front	voorzijde
chamber	kamer
excitation	opwinding
manipulation	manipulatie
selecting	selecteren
saturated	verzadigd
breaking	breken
participation	deelname
press	drukken
stated	bepaald
lethality	letaliteit
produced	geproduceerd
intestinal	darm
en	en
faced	geconfronteerd
aches	pijnen
farmers	boeren
casualty	ongeval
sugars	suikers
took	duurde
damages	beschadigingen
nutrients	nutriënten
intolerance	intolerantie
optometrist	optometrist
felt	gevoeld
wanted	gezocht
situated	gelegen
lag	achterblijven
infectious	besmettelijk
earth	aarde
mesmerism	hypnose
creative	creatieve
there	sprake
piece	stuk
contributions	bijdragen
chest	borst
newest	nieuwste
decision-making	besluitvorming
microorganisms	micro-organismen
began	begon
states	verklaart
part	gedeelte
selected	gekozen
german	duitse
accidents	ongelukken
faster	sneller
says	zegt
dry	droge
expects	verwacht
greater	groter
dysfunction	disfunctie
ago	geleden
means	inhoudt
chorea	chorea
definition	definitie
throughout	overal
squeezing	knijpen
returns	terugkomt
to	ter
pleural	meervoud
1986	1986
stage	stadium
repetition	herhaling
ill	zieken
diagnostic	diagnostisch
medic	medisch
childhood	kinderleeftijd
subject	proefpersoon
anaesthesiologist	anesthesioloog
itching	jeuk
phenomenon	fenomeen
behind	achter
anxiety	angst
incidence	incidentie
bnp	bnp
type	typen
vs	vs
anticoagulation	antistolling
discovered	ontdekten
hormone	hormoon
scratching	krabben
ideal	ideale
f	f
blue	blauw
divided	verdeeld
rate	tarief
stimulating	stimulerende
share	delen
forward	voren
gall	gal
professional	professional
nash	nash
support	steun
reimbursement	vergoeding
therapeutics	therapie
catheter	catheter
transported	vervoerd
gist	kern
limbs	ledematen
pharmacy	apotheek
police	politie
above	bovenstaande
link	verbinden
attack	aantasting
experiencing	ervaren
administered	toegediende
meningitis	hersenvliesontsteking
ruminal	pens
sexual	seksueel
quantitative	kwantitatieve
30	30
deemed	geacht
victim	slachtoffer
borrelia	borrelia
tracer	tracer
limb	ledemaat
urination	urineren
le	le
optometry	optometrie
guided	geleid
abroad	buitenland
organ	orgaan
cost	kosten
shunts	shunts
neural	neurale
things	dingen
laparotomy	laparotomie
ceramide	ceramide
magnetic	magnetische
observation	observatie
hinders	belemmert
action	actie
sores	zweren
bovine	boviene
intestines	darmkanaal
five	vijf
mitosis	celdeling
syphilis	syfilis
divided	onderverdeeld
eggs	eieren
are	zijn
coughing	hoesten
&amp;apos;	&amp;apos;
influencing	beïnvloeden
same	dezelfde
poisons	vergiften
build	aanleggen
choose	kiest
2006	2006
hit	raakte
fast	snelle
progressive	progressief
puberty	puberteit
dermatologist	dermatoloog
48	48
birds	vogels
biology	biologie
edema	oedeem
exact	precieze
place	plaats
issues	problematiek
short	korte
china	china
namely	namelijk
size	maat
preparation	bereiding
trained	getraind
multidisciplinary	multidisciplinair
leather	leer
suitable	geschikt
carbamazepine	carbamazepine
acts	handelt
forced	gedwongen
sinus	sinus
saline	zoutoplossing
amputations	amputaties
soles	voetzolen
discipline	vakgebied
illnesses	ziekten
phenomenon	verschijnsel
construction	aanleg
do	doet
beats	slaat
desensitization	desensibilisatie
approval	goedkeuring
fracture	fractuur
knees	knieën
confused	verward
swallow	inslikken
&gt;	&gt;
secondarily	secundair
uses	toepassingen
founded	richtten
good	goed
signal	signaal
calculus	rekening
below	onder
preventive	preventieve
advent	komst
before	alvorens
animal	dierlijk
hairs	haren
fail	falen
questions	vragen
sleepiness	slaperigheid
down	beneden
ii	ii
saw	zagen
expression	expressie
nuclear	nucleaire
quiet	stil
deviant	afwijkend
epileptic	epileptische
ideas	ideeën
constricted	vernauwde
objective	doelstelling
disadvantage	nadeel
considered	overwogen
onto	naar
mentally	geestelijk
while	terwijl
37	37
tap	kraan
as	als
nonetheless	toch
naturally	uiteraard
medical	medische
alcohol	alcohol
temporal	tijdelijk
droplet	druppel
repeatedly	herhaaldelijk
dry	uitdrogen
diagnosing	diagnosticeren
changes	verandert
british	britse
colleague	collega
antipsychotics	antipsychotica
diseases	aandoeningen
cerebrovascular	cerebrovasculair
extrinsic	extrinsieke
major	groot
decreases	vermindert
psychologists	psychologen
potentially	mogelijk
psychiatrist	psychiater
standards	standards
fountain	fountain
urethritis	urethritis
dissemination	verspreiding
frozen	bevroren
drainage	afvloed
bees	bijen
treating	behandelende
controlled	gecontroleerde
acrocyanosis	acrocyanose
have	hebben
covered	bedekt
hosts	gastheren
trunk	romp
lead	leiden
history	anamnese
fiber	vezel
pockets	zakken
permission	toestemming
puncture	punctie
relax	ontspannen
1978	1978
b.c.	v.chr.
audience	publiek
uptake	opname
impaired	verzwakt
probably	waarschijnlijk
defect	defect
established	opgericht
materials	materialen
teeth	gebit
put	leggen
destruction	vernietiging
caregiver	zorgverlener
noxious	schadelijk
practice	practice
used	gehanteerd
coagulation	stolling
body	lichaam
universities	universiteiten
neurosurgeon	neurochirurg
appear	verschijnen
familial	familiaire
exchange	uitwisseling
temporal	temporale
crying	huilen
experience	ervaring
lie	liggen
plaster	pleister
counseling	begeleiding
disabled	uitgeschakeld
unit	unit
moist	vochtige
lastly	tenslotte
even	zelfs
after	na
about	over
sue	vervolgen
adult	volwassene
when	wanneer
guarantee	garanderen
conjugated	geconjugeerd
blockage	verstopping
chemicals	chemicaliën
versions	versies
dark	donker
address	richten
visual	visuele
camera	camera
germ	ziektekiem
results	uitslagen
early	vroeg
failure	uitblijven
urinate	urineren
sweating	zweten
in-house	intern
insurance	verzekeringen
less	less
paragonimus	paragonimus
major	major
so-called	zogenaamde
3	3
streptococci	streptokokken
objects	objecten
organisations	organisaties
rise	stijgen
initial	initiële
advises	adviseert
dwell	wonen
ovulation	eisprong
practical	praktische
involuntary	onwillekeurige
wholly	geheel
investigated	onderzochte
underneath	onder
axilla	oksel
acetylcholine	acetylcholine
caries	cariës
poor	arm
includes	behelst
populations	populaties
desired	gewenst
nidra	nidra
regulation	regulatie
places	plaatsen
gentamicin	gentamicine
encompasses	omvat
secure	veilige
mesh	netwerk
internal	interne
term	term
leiden	leiden
psychiatric	psychiatrische
swimming	zwemmen
toxicities	toxiciteit
remained	bleef
psychopathology	psychopathologie
cranial	schedel
staining	kleuring
through	via
streptococcal	streptokokken
vomiting	braken
rises	ontspringt
directing	leiden
er	er
bypass	bypass
poisonous	giftig
preparation	voorbereiding
test	testen
so	zo
consciously	bewust
scar	litteken
alleles	allelen
2nd	2e
senses	zintuigen
ultraviolet	ultraviolette
eyeglasses	bril
pay	betaalt
species	soorten
safely	veilig
regular	regelmatige
painful	pijnlijk
pains	weeën
adi	adi
ipecac	ipecac
digital	digitale
persistent	persisterend
degree	graad
flushed	gespoeld
joining	aansluiting
contributes	draagt
nature	aard
practiced	beoefend
back	achterste
if	als
heavily	hard
defibrillator	defibrillator
render	geven
asia	azië
chemist	chemicus
indirect	indirect
caregiver	hulpverlener
returns	keert
anaesthesiologists	anesthesiologen
daily	dagelijks
statistically	statistisch
relations	relaties
watching	let
atherosclerotic	atherosclerotische
insight	inzicht
toothbrush	tandenborstel
18th	18e
aphasia	afasie
retained	tegengehouden
persistent	persisterende
named	genoemde
american	amerikaans
green	groene
blame	wijten
retrograde	retrograde
sorts	soorten
alpha-linolenic	alfa-linoleenzuur
bow	beugel
went	ging
specificity	specificiteit
perform	uitvoeren
cavity	holte
one	iemands
toward	naar
established	vastgestelde
sugar	suiker
signal	signaaloverdracht
tracking	bijhouden
anesthesiologist	anesthesioloog
comparison	vergelijking
started	begonnen
ear	oor
v	v
responded	gereageerd
apple	appel
excellent	uitstekende
duct	kanaal
detected	gedetecteerd
spine	ruggengraat
if	indien
consultation	overleg
improving	verbeteren
purple	paarse
susceptible	vatbaar
constant	constante
restless	onrustig
tissue	weefsel
researched	onderzocht
cervix	hals
request	opvragen
when	waarop
fruits	fruit
called	zogeheten
guarantee	garantie
erythrocytes	erytrocyten
ensure	verzekeren
proboscis	proboscis
bearing	lager
1959	1959
pass	passeren
applied	toegepast
partially	gedeeltelijk
shortly	kortweg
relapse	recidief
bone	benen
effective	daadwerkelijke
cesarean	keizersnede
compare	vergelijken
both	beide
flat	plat
mature	volwassen
firms	bedrijven
number	aantal
thereafter	daarna
expectancy	verwachting
get	halen
sure	zeker
incidences	incidentie
aesthesiometer	monofilament
truly	werkelijk
possibilities	mogelijkheden
bridge	brug
beak	bek
characteristic	kenmerk
250	250
10	10
occasion	aanleiding
crossing	kruising
services	voorzieningen
separated	gescheiden
summarized	samengevat
removed	weggenomen
parties	partijen
gynecology	gynaecologie
clinically	klinisch
contagious	besmettelijk
opportunistic	opportunistische
subcutaneous	onderhuidse
extensive	uitgebreide
ketoacidosis	keto-acidose
cbs	cbs
around	rondom
gets	terechtkomt
epidural	epidurale
place	plek
authorities	overheid
survive	doormaken
listening	luisteren
greatest	beste
education	onderwijs
reliable	betrouwbare
thrombosis	trombosebeen
clear	duidelijke
serious	ernstig
sleep	slapen
close	sluiten
pure	zuiver
deliver	afgeven
go	gaan
striking	opvallend
regard	beschouwen
remainder	rest
migrate	trekken
feature	kenmerk
socially	maatschappelijk
repeated	herhaalde
costly	duur
comprehension	begrip
advise	adviseren
united	verenigde
asking	vragen
charges	kosten
lack	gebrek
low	geringe
contamination	besmetting
soldiers	soldaten
disorders	aandoeningen
endophthalmitis	endoftalmitis
significant	significante
suspected	vermoed
myxoma	myxoom
archetype	archetype
not	niet
6	6
directions	richtingen
membranes	membranen
depends	afhankelijk
sought	gezocht
balloon	ballon
concept	concept
pupil	pupil
accident	accident
hallucinations	hallucinaties
label	etiket
money	geld
saw	zag
partial	gedeeltelijke
international	internationale
blisters	blaren
periodontal	parodontale
desmoteplase	desmoteplase
similar	soortgelijke
change	veranderingen
fish	vissen
facing	geconfronteerd
between	daartussen
1953	1953
toothbrushes	tandenborstels
sensitive	gevoelig
rating	beoordeling
affect	aantasten
find	vinden
health-care	gezondheidszorg
minority	minderheid
paracetamol	paracetamol
support	ondersteunend
capsule	capsule
gifts	gaven
gypsum	gips
next	naast
formerly	vroeger
narrow	vernauwen
build-up	opbouwen
according	volgens
2,000	2000
cases	gevallen
cured	genezen
respond	reageren
relates	betrekking
financial	financieel
damage	schade
stitches	steken
on	on
certainly	zeker
cold	verkoudheid
millions	miljoenen
straight	rechte
inflamed	ontstoken
gravis	gravis
palsy	verlamming
driven	aangedreven
quiet	rustig
financing	financiering
human	humane
plan	plan
jaws	kaken
primitive	primitieve
extended	verlengde
prepare	bereiden
students	studenten
university	universitair
ligament	ligamentum
typical	typische
ate	gegeten
immunoglobulin	immunoglobuline
prevention	voorkómen
flesh	vlees
germs	kiemen
done	gedaan
enlarges	vergroot
centimeter	centimeter
rough	grof
placing	plaatsing
survival	overleving
b	b
cramps	krampen
amalgam	amalgaam
individual	individuele
meaningful	zinvol
preserved	bewaard
dislocation	ontwrichting
recurrence	herhaling
there	aldaar
splinter	splinter
before	voordien
company	bedrijf
machines	machines
several	verscheidene
include	omvatten
narrative	verhaal
drug	drug
spices	kruiden
never	nooit
piece	stukje
cardiologist	cardioloog
december	december
necessary	vereist
broken	kapot
thomas	thomas
extended	langere
stored	opgeslagen
diminished	verminderde
episiotomy	episiotomie
implanted	geïmplanteerd
willis	willis
brussels	brussel
hemostasis	hemostase
retard	vertragen
"	“
lost	verloren
sudden	plotselinge
hellp	hellp
intravenous	intraveneuze
agencies	instanties
yogi	yogi
leaning	neiging
biliary	gal
strokes	herseninfarcten
kidneys	nieren
morphine	morfine
because	omwille
passed	overgegaan
consumed	geconsumeerd
narcotic	verdovende
yeasts	gisten
motion	beweging
inhibitor	inhibitor
naturally	natuurlijk
adenoid	neusamandel
belgian	belgische
ventricles	hartkamers
or	ofwel
despite	ondanks
sweet	zoet
below	onderstaande
newborns	pasgeborenen
applying	aanbrengen
genetic	genetische
progressive	progressive
autonomous	autonoom
nutrients	voedingsstoffen
junior	jongere
i	i
inguinal	inguinale
house	house
mosaicism	mozaïcisme
comes	komt
recommend	aanbevolen
anterograde	anterograde
basal	basale
independent	zelfstandig
surgical	chirurgisch
warmth	warmte
hemisphere	hemisfeer
bls	bls
entirely	geheel
appear	lijken
uterus	baarmoeder
whether	of
preserve	behouden
peter	peter
sebaceous	vet
tibial	scheenbeen
putting	zetten
withdrawal	opname
february	februari
teeth	tanden
syringes	spuiten
inside	binnenkant
band	band
rostrum	rostrum
observe	waarnemen
melanoma	melanoom
neuromodulation	neuromodulatie
conditions	voorwaarden
doping	doping
follows	volgt
contributed	bijgedragen
hallux	hallux
fracture	breuk
accompanied	vergezeld
ophthalmologist	oogarts
mosquito	mug
16	16
thereby	daardoor
125	125
illness	ziekte
ricinoleic	ricinolzuur
haemorrhage	bloeding
number	tal
comparable	vergelijkbare
cad	cad
inverted	omgekeerde
almost	nagenoeg
economic	economische
sufficient	voldoende
dermis	lederhuid
early	vroegtijdige
plumbing	leidingen
glycemic	glykemische
improvement	verbetering
wears	draagt
on	op
subdivided	onderverdeeld
complaint	klacht
ch	ch
relationship	verwantschap
press	indrukken
oily	vette
diversity	diversiteit
mass	massa
aid	steun
findings	bevindingen
unsaturated	onverzadigd
consequence	gevolg
living	leven
cannabis	cannabis
hospital	ziekenhuis
scratch	krabben
live	wonen
mortality	mortaliteit
foster	bevorderen
actually	eigenlijk
heightened	verhoogde
provisions	bepalingen
show	tonen
set	reeks
stains	vlekken
local	lokaal
sensation	gevoel
harmful	schadelijk
pocket	zak
palate	verhemelte
controlling	regelen
dry	droog
mandibular	onderkaak
perform	verrichten
scarring	littekenvorming
amsterdam	amsterdam
some	sommige
consume	nuttigen
achieving	bereiken
stages	stadia
medium	medium
description	beschrijving
a.	a.
heritability	erfelijkheid
likewise	hetzelfde
like	dergelijk
result	gevolg
neoplasia	neoplasie
somatic	somatische
institute	instituut
bacterial	bacterie
psychiatry	psychiatrie
rumination	rumineren
differing	afwijkende
induction	inductie
1960	1960
prostatic	prostaat
adenoids	neusamandel
biologically	biologisch
"	„
puncture	gaatje
endometrial	endometrium
it	erin
ulcerations	zweren
discontinue	staken
outcome	resultaat
resin	kunsthars
intracardiac	intracardiale
immediate	onmiddellijk
sensory	sensorische
statistic	statistisch
washington	washington
paper	papier
organisms	organismen
smaller	kleiner
canal	kanaal
perhaps	wellicht
(	(
psoriasis	psoriasis
set	set
constructed	opgebouwd
turnover	omzet
obstructed	belemmerd
during	tijdens
distance	afstand
such	zodanig
whole	geheel
statistical	statistisch
angiotensin	angiotensine
secondary	middelbare
extend	breiden
migraine	migraine
point	wijzen
scabies	scabies
hospitalized	ziekenhuis
rest	rest
use	gebruikmaken
rash	uitslag
achieve	bereiken
back	achterzijde
bloody	bloederige
published	verschenen
lies	ligt
exposed	blootgesteld
flukes	botten
swollen	gezwollen
mendelian	mendel
bodily	lichamelijk
precise	nauwkeurig
physical	fysieke
expect	verwachten
probable	waarschijnlijk
treating	behandelend
kleine	kleine
sound	geluid
discussing	bespreken
intended	bedoeld
topically	plaatselijk
substitution	vervanging
publication	publicatie
occlusion	afsluiting
sucked	gezogen
will	zal
analysis	analyse
thrombophlebitis	tromboflebitis
dilution	verdunning
administration	toediening
clinician	behandelaar
passively	passief
areas	gebieden
itself	zelf
restoring	herstellen
arousal	opwinding
deeply	diep
mortality	sterfte
migraines	migraine
tomography	tomography
device	apparaat
stop	tegenhouden
scientifically	wetenschappelijk
etc.	enzovoort
penile	penis
beneath	onder
1992	1992
dissociation	dissociatie
missing	ontbreekt
hot	warm
9	9
nationwide	landelijk
general	general
rural	landelijk
diabetes	diabetes
coronal	kroon
counted	geteld
americas	amerika
their	hun
analyze	analyseren
percutaneous	percutane
enamel	glazuur
thin	verdunnen
related	verwant
isotopes	isotopen
lightheadedness	duizeligheid
bronchial	bronchiale
favorable	gunstige
tape	band
fertilization	bevruchting
tended	neiging
each	elke
life	leven
gently	voorzichtig
whereby	waardoor
strong	sterke
corpus	corpus
common	voorkomende
manual	handboek
concussions	hersenschudding
nitrogen	stikstof
blot	vlek
shock	schokken
stroke	beroerte
related	gerelateerd
analyzed	geanalyseerd
stratum	laag
support	ondersteunende
tumour	tumor
reduced	verkleind
usa	vs
ovaries	eierstokken
doses	doseringen
on	opgelopen
sink	gootsteen
should	dienen
male	mannelijke
using	gebruiken
shows	toont
weight-loss	gewichtsverlies
night	nachts
main	grootste
metastasis	metastase
organized	georganiseerd
occur	voorkomen
toxicity	giftigheid
classical	klassiek
sciences	wetenschappen
effort	moeite
street	straat
sluggish	traag
stents	stents
rarer	zeldzamer
single	enkel
wounded	gewonde
declined	gedaald
european	european
depth	diepte
start	starten
unintentional	onbedoeld
adaptive	aangepaste
pox	pokken
forcibly	gedwongen
fatal	fataal
mainstream	reguliere
larynx	strottenhoofd
best	beste
17	17
broad	globale
verified	gecontroleerd
hemorrhage	bloeduitstorting
fibroids	vleesbomen
worked	gewerkt
issued	uitgegeven
professional	professionele
du	du
nursing	verpleegkundig
violent	hevige
lasting	blijvend
try	proberen
tobramycin	tobramycine
ruptures	breuken
toxicology	toxicologie
spread	verspreid
counted	gerekend
ms	ms
other	andere
sotos	sotos
apothecaries	apothekers
conventional	gebruikelijke
flux	stroom
filaggrin	filaggrine
dermis	huid
blister	blaar
describes	beschrijft
successful	geslaagd
laparoscopic	laparoscopische
which	hetgeen
healthy	gezonde
ova	eicellen
feels	voelt
hematocrit	hematocriet
nutrient	voedingsmiddel
endotracheal	endotracheale
suicide	zelfdoding
it	mee
joseph	joseph
intoxication	vergiftiging
replacement	vervanging
nice	fijn
fractures	fracturen
seek	zoeken
pull	trekken
strain	stam
mobile	mobiele
extent	mate
pigs	varkens
patron	patroon
branches	takken
towards	naar
expiration	afloop
hour	uur
improve	verbeteren
elicit	uitlokken
phospholipid	fosfolipiden
necessary	noodzakelijk
model	model
exchange	wisselen
guidewire	voerdraad
accomplish	bereiken
bleeding	bloedingsneiging
reabsorption	terugresorptie
theories	theorieën
mask	masker
intentional	opzettelijk
35	35
values	waardes
stress	stress
tasks	taken
eyeball	oogbol
potent	krachtig
toxic	toxische
artery	arteriae
seventh	zevende
barbiturate	barbituraat
evolution	evolutie
inferior	mindere
microalbuminuria	microalbuminurie
chocolate	chocolade
sudden	plotseling
including	waaronder
vital	vitaal
flavonoids	flavonoïden
contraction	samentrekking
asthma	astma
parameters	parameters
favorable	gunstig
fasciculation	fasciculatie
code	code
elderly	ouderen
homologous	homologe
pathway	weg
activation	activatie
vera	vera
1962	1962
-	-
scissors	schaar
classical	klassieke
toxicological	toxicologisch
circulatory	bloedsomloop
suppress	onderdrukken
implement	uitvoeren
compensate	compenseren
radial	radialis
clinics	klinieken
hospital	hospitaal
increase	toenemen
preventive	preventief
inner	binnenste
neurologic	neurologische
healed	genezen
cautery	cauterisatie
existing	bestaande
visit	bezoeken
roles	rollen
resources	middelen
cva	cva
client	cliënt
falling	behorende
speech	spraak
abolished	afgeschaft
molecule	molecuul
needles	naalden
visible	zichtbaar
holds	houdt
wake	wekken
internally	inwendig
immunological	immunologische
difficult	moeilijker
index	index
linoleic	linolzuur
any	elke
another	ander
synthesize	synthetiseren
bond	binding
superseded	vervangen
mucosa	slijmvlies
consider	overwegen
take	neemt
annually	jaarlijks
interest	belangstelling
output	uitgang
activate	activeren
application	toepassing
overview	overzicht
diffusion	verspreiding
paul	paul
found	vond
psychology	psychologie
ulcers	zweren
allele	allel
ulnar	ulnare
defenses	afweer
placed	geplaatst
prevent	voorkomen
avoiding	vermijden
space	ruimte
maintain	onderhouden
horner	horner
constrict	samentrekken
models	modellen
appointments	afspraken
synonym	synoniem
molar	kies
thicker	dikker
adapted	aangepaste
fertilized	bevruchte
-	–
bactericidal	bactericide
west	westen
away	heen
hence	dus
administration	bestuur
nevertheless	niettemin
trade	handel
smooth	glad
comments	reacties
cyst	cyste
yes	ja
total	totaal
fine	fijne
sedation	sedatie
human	menselijke
placebo	placebo
h	h
ends	eindigt
bachelor	bachelor
forceps	tang
eyedrops	oogdruppels
2012	2012
rests	rust
350	350
cooperation	samenwerking
comprehensive	uitgebreid
got	gekregen
exceeds	overschrijdt
te	te
exclude	uitsluiten
contrast	contrast
intense	hevig
lobe	kwab
species	diersoort
movements	bewegingen
workers	werknemers
detecting	detecteren
drink	drinken
improperly	onrechte
coherent	samenhangend
indirectly	indirect
book	boek
her	haar
medics	medici
having	hebben
composed	samengesteld
implementing	uitvoering
directly	direct
argument	argument
had	gehad
applied	aangelegd
pus	pus
esthesiometer	monofilament
responding	reageert
manufacturer	fabrikant
decided	besloten
initial	eerste
childbirth	bevalling
phenotype	fenotype
designation	benaming
sections	afdelingen
toxin	toxine
breathe	ademen
milled	gefreesd
properties	eigenschappen
estimate	schatting
be	worden
experience	ondervindt
line	lijn
afterward	nadien
harsh	hard
spinal	spinale
sun	zon
contagious	besmettelijke
by	door
2014	2014
fall	vallen
made	gemaakt
border	grens
william	william
reservoir	reservoir
ends	mondt
gravity	zwaartekracht
paying	betalen
remained	gebleven
average	doorsnee
pair	paar
reaction	reactie
specialist	specialist
popular	populair
vasculature	vaatstelsel
comprise	omvatten
army	leger
dilatation	verwijding
membrane	membraan
transfused	transfusie
acute	acuut
elsewhere	elders
qaly	qaly
procedural	procedurele
attacks	aanvallen
secretion	afscheiding
non-specific	niet-specifieke
accumulation	ophoping
hiccup	hik
move	zet
private	particuliere
epidemic	epidemie
plasmapheresis	plasmaferese
bone	botweefsel
decision	besluitvorming
shaping	vorming
retrograde	achteruitgang
gi	gi
decreases	verkleint
article	artikel
thumb	duim
remembering	herinneren
times	tijden
single	eenmalige
antibiotics	antibiotica
dosing	dosering
bilirubin	bilirubine
manner	manier
pregnancy	zwangerschap
ultraviolet	ultraviolet
1900s	1900
stop	stoppen
subsequent	volgend
infect	besmetten
offered	aangeboden
microbiology	microbiologie
glucose	glucose
small	gering
primary	primair
mobility	beweeglijkheid
allergies	allergieën
produces	produceert
therapist	arts
translation	translatie
home	huis
cancer	cancer
ileum	ileum
massage	masseren
ranging	variërend
path	pad
detect	detecteren
strengthened	versterkte
variola	pokken
foreign	lichaamsvreemde
many	velen
with	met
tremor	tremor
systemic	systemische
addiction	verslaving
chew	kauwen
seeks	zoekt
could	mocht
choosing	kiezen
missed	gemist
myeloproliferative	myeloproliferatieve
researchers	onderzoekers
atrophy	atrofie
health	ziektekosten
sharp	scherpe
disease	vaatziekten
claims	claims
want	wil
typing	typen
quite	nogal
lessons	ervaring
seems	lijkt
flow	vloeien
oocyte	eicel
use	gebruiken
increases	stijgt
conspicuous	opvallend
autosomal	autosomaal
condition	conditie
amplified	versterkte
implemented	geïmplementeerd
attack	aanval
criterion	criterium
thought	meende
insufflation	beademing
regional	regionale
created	gemaakt
cycle	cyclus
later	later
mother	moeder
cover	afdekken
leaves	bladeren
easy	gemakkelijk
constant	constant
variants	varianten
already	al
compared	vergeleken
scab	schurft
affected	aangedane
someone	iemand
located	gelegen
people	mensen
wavelength	golflengte
ai	ai
laboratories	laboratoria
nucleus	kern
sunlight	zonlicht
iodine	jodium
trachea	luchtpijp
nine	negen
significant	significant
protocols	protocollen
drugs	medicamenten
reasonable	redelijk
meningeal	hersenvlies
came	kwam
fits	past
detrimental	schadelijk
healing	geneeskrachtige
rely	vertrouwen
benign	benigne
vessels	bloedvaten
abnormal	abnormale
indeed	inderdaad
readily	gemakkelijk
went	gegaan
brands	merken
specializing	gespecialiseerd
