!	!
%	%
&	&
&amp;	&amp;
&amp;apos;	&amp;apos;
&apos;	&apos;
&gt;	&gt;
&quot;	&quot;
*	*
+	+
,	,
-	--
-	—
.	.
..	..
0	0
0.8	0,8
1	1
1,000	1000
1-2	1-2
1-3	1-3
1.5	1,5
100	100
100,000	100.000
12th	12e
13	13
13th	13e
14	14
15	15
150	150
1847	1847
1900	1900
1960s	1960
1970s	1970
1971	1971
1980	1980
1986	1986
1987	1987
1988	1988
1994	1994
1995	1995
1996	1996
1997	1997
1998	1998
19th	19e
2	2
2.5	2,5
20	20
200	200
2000	2000
2001	2001
2003	2003
2005	2005
2006	2006
2007	2007
2008	2008
2010	2010
2011	2011
2015	2015
20th	20e
21	21
22	22
23	23
27	27
28	28
29	29
3.5	3,5
30	30
300	300
36	36
365	365
4.5	4,5
40	40
400	400
42	42
45	45
47	47
48	48
4th	4e
5	5
5,000	5000
50	50
500	500
5000	5000
60	60
65	65
7	7
70	70
75	75
8	8
85	85
95	95
96	96
:	:
;	;
?	?
_	_
a	a
a	een
a	eén
a	één
abbreviated	afgekort
abdomen	buik
aberrant	afwijkend
ability	vermogen
ablation	verwijdering
abnormalities	afwijkingen
abnormality	afwijking
abnormally	abnormaal
abortion	abortus
about	hierover
about	omtrent
above	boven
above	bovenstaande
abroad	buitenland
abscesses	abcessen
absence	afwezigheid
absolute	absolute
absolute	absoluut
abuse	misbruik
academic	academische
accelerate	versnellen
accelerated	versneld
accelerated	versnelde
acceptable	aanvaardbare
accepted	geaccepteerd
access	toegang
accessible	beschikbaar
accessible	toegankelijk
accident	ongeluk
accident	ongeval
accidentally	toevallig
accidents	ongelukken
accidents	ongevallen
accompany	begeleiden
accounted	goed
accumulate	ophopen
accurately	nauwkeurig
accurately	nauwkeuriger
accused	verdachte
acetaminophen	paracetamol
ache	pijn
aches	pijnen
achieved	gehaald
acid	zuur
acidic	zure
acidity	zuurgraad
acidosis	acidose
acknowledged	erkend
acne	acne
acquire	verkrijgen
across	over
act	act
act	fungeert
act	handeling
action	actie
activated	geactiveerd
activates	activeert
activating	activeren
active	actief
active	actieve
active	werkzame
actively	actief
activities	activiteiten
activities	werkzaamheden
activity	werkzaamheid
acts	handelt
actual	daadwerkelijk
actually	feite
actually	werkelijk
acupuncture	acupunctuur
acutely	acuut
adapt	aanpassen
adaptations	aanpassingen
adapted	aangepast
adapting	aanpassen
add	toevoegen
added	toegevoegd
addictive	verslavend
additional	aanvullende
additional	bijkomend
additional	bijkomende
additional	extra
additionally	bovendien
additive	toevoeging
addressed	aangepakt
adequate	adequaat
adequate	voldoende
adequately	adequaat
adhd	adhd
adjust	aanpassen
adjusting	aanpassen
adjustment	aanpassing
adjustments	aanpassingen
administered	toegediend
administered	toegediende
administering	toedienen
administration	administration
admitted	toegelaten
adrenaline	adrenaline
adults	volwassenen
advanced	geavanceerde
advanced	gevorderd
advent	komst
adverse	nadelige
advisable	raadzaam
advised	adviseerde
advised	geadviseerd
af	af
affect	aantast
affected	aangedaan
affected	aangetast
affected	aangetaste
affected	beïnvloed
affected	getroffen
affecting	invloed
affinity	affiniteit
africa	afrika
after	nadat
afterwards	daarna
again	opnieuw
again	weer
against	tegen
age	leeftijd
aged	oud
agenda	agenda
agglutination	agglutinatie
aggressive	agressieve
agitated	bewogen
ago	geleden
agraphia	agrafie
agree	overeenkomen
ahc	ahc
aid	hulpmiddel
aid	hulpverlening
aids	aids
aimed	gericht
aiming	streven
aims	streeft
air	lucht
airway	ademweg
airway	luchtweg
al	al
alarm	alarm
albert	albert
albicans	albicans
albumin	albumine
albuminuria	albuminurie
alert	alarm
alexander	alexander
algae	algen
align	richten
alive	levend
alkalosis	alkalose
all	alle
all	allemaal
all	hele
all	helemaal
allergen	allergeen
allergenic	allergeen
allergens	allergenen
allergic	allergische
allergy	allergie
almost	bijna
alone	alleen
along	langs
alongside	naast
already	reeds
als	als
also	tevens
alter	wijzigen
alteration	wijziging
altered	gewijzigd
alternately	afwisselend
alternative	alternatief
alternative	alternatieve
alternatively	alternatief
alters	verandert
although	hoewel
although	weliswaar
alveolar	alveolaire
ambient	omringende
amenable	vatbaar
amended	gewijzigd
america	amerika
american	american
american	amerikaanse
aminoglycosides	aminoglycosiden
amnesia	amnesie
amnesia	geheugenverlies
amniotic	vruchtwater
amphetamine	amfetamine
amphibians	amfibieën
amplify	versterken
amputation	amputatie
amputations	amputaties
an	een
anaemia	anemie
anaerobic	anaerobe
anaesthesia	anesthesie
anaesthesiologist	anesthesioloog
anal	anale
analgesia	verdoving
analog	analoog
analogous	analoog
analogue	analoog
anaphylactic	anafylactische
anaphylaxis	anafylaxie
anatomic	anatomische
anatomical	anatomisch
anatomy	anatomie
ancient	oude
and	alsmede
and	en
and	én
anemia	anemie
anemia	bloedarmoede
anencephaly	anencefalie
anesthesia	anesthesie
anesthesia	verdoving
anesthesiologists	anesthesiologen
anesthesiology	anesthesiologie
anesthetic	anestheticum
anesthetized	verdoofd
aneurysmal	aneurysma
aneurysms	aneurysmata
angina	angina
angiogenesis	angiogenese
angiography	angiografie
angioplasty	angioplastiek
angry	ontstoken
animal	dierlijk
animal	dierlijke
animals	dieren
annual	jaarlijkse
anomalies	afwijkingen
anomalous	abnormaal
anomaly	afwijking
answer	antwoord
answers	antwoorden
antagonist	antagonist
anterior	anterior
anterior	voorste
anteriorly	anterior
antibiotic	antibioticum
antibodies	antilichamen
antibodies	antistoffen
antibody	antilichaam
antibody	antistof
anticoagulation	antistolling
antidepressant	antidepressiva
antidepressants	antidepressiva
antidote	tegengif
antigen	antigeen
antigens	antigenen
antimicrobial	antimicrobiële
antiquity	oudheid
anuria	anurie
anus	anus
anxieties	angsten
anxiety	angst
any	eventuele
anyone	iedereen
anything	iets
anywhere	overal
aorta	aorta
aortic	aorta
apart	uiteen
aperture	opening
apex	top
aphasics	afasie
apnea	apneu
apoptosis	apoptose
appeal	beroep
appearance	optreden
appearance	uiterlijk
appearance	uitstraling
appeared	verschenen
appearing	verschijnen
appliances	apparaten
applied	toegepaste
apply	geldt
appointment	afspraak
approach	aanpak
approval	goedkeuring
approved	aangenomen
approved	goedgekeurd
approximately	ongeveer
april	april
arachidonic	arachidonzuur
archetypes	archetypen
are	bent
are	zijn
area	gebied
arisen	ontstane
arises	ontstaat
arm	arm
arms	armen
arose	ontstond
around	rond
array	reeks
arrested	aangehouden
arrhythmias	hartritmestoornissen
art	kunst
arterial	arteriële
arteries	arteriën
arterioles	arteriolen
arteriosclerosis	arteriosclerose
arteriovenous	arterioveneuze
artery	arteria
artery	arterie
artery	artery
arthritis	artritis
articular	articulair
articular	articulaire
articulator	gewricht
artificial	kunstmatig
artificial	kunstmatige
artificially	kunstmatig
as	naargelang
as	zoals
ascites	ascites
ash	as
ask	vragen
asked	gesteld
asked	gevraagd
aspect	aspect
asphyxia	asfyxie
asphyxia	verstikking
asphyxiation	verstikking
assay	analyse
assay	assay
assessing	beoordelen
assist	helpen
assistance	begeleiding
assisted	geholpen
assistive	ondersteunende
associated	geassocieerd
assume	aannemen
assure	verzekeren
asthma	asthma
at	bij
atherosclerosis	atherosclerose
athlete	atleet
athletes	atleten
athletes	sporters
atmosphere	sfeer
atrium	atrium
atropine	atropine
attack	aantasting
attain	bereiken
attempt	poging
attempting	proberen
attempts	pogingen
attempts	probeert
attendance	opkomst
attention	aandacht
attenuated	verzwakt
attributed	toegeschreven
atypical	atypische
augment	vergroten
aura	aura
auras	aura
aureus	aureus
australia	australië
autism	autisme
autoimmune	auto
automatic	automatisch
automatic	automatische
automatically	automatisch
autonomic	autonoom
autonomous	autonome
available	beschikbaar
available	beschikbare
available	verkrijgbaar
available	voorhanden
average	gemiddeld
average	gemiddelde
averaged	gemiddeld
avoid	vermijden
avoided	vermeden
awake	wakker
awarded	toegekend
awarded	uitgereikt
aware	bewust
awareness	bewustzijn
awareness	voorlichting
away	weg
azoospermia	azoöspermie
b.	b.
b12	b12
b6	b6
baby	baby
bacillus	bacil
back	achterkant
back	terug
background	achtergrond
bacteria	bacterie
bacterium	bacterie
bacteriuria	bacteriurie
bag	zak
balance	evenwicht
balloon	ballonnetje
bandage	verband
bank	bank
banned	verboden
barber	barbier
barbiturates	barbituraten
bark	schors
barrier	barrière
base	basis
based	gebaseerd
basic	basis
basically	eigenlijk
basilar	basilaris
basis	basis
basis	grondslag
bath	bad
battle	strijd
be	verkeren
bear	verdragen
beat	kloppen
beat	slaan
beating	kloppende
beats	klopt
beats	slaat
because	aangezien
because	doordat
because	omdat
because	want
become	geworden
become	word
become	worden
becomes	wordt
becoming	worden
bed	bed
bee	bij
before	alvorens
before	voor
began	begon
beginning	begin
begun	begonnen
behave	gedragen
behavior	gedragsproblemen
behaviour	gedrag
behind	achter
behind	achteren
being	wezen
belgium	belgië
belly	buik
belong	behoren
belonging	behorende
belongs	behoort
below	beneden
below	onder
bend	buigen
beneficial	gunstig
benefit	behoeve
benefit	voordeel
benefits	voordelen
benign	goedaardig
benzodiazepines	benzodiazepines
beside	daarnaast
best	best
best-known	bekendste
better	betere
beverage	drank
beverages	dranken
beyond	verderop
bfs	bfs
bicarbonate	bicarbonaat
bigger	groter
biggest	grootste
biliary	galwegen
bill	rekening
bind	binden
binds	bindt
biofeedback	biofeedback
biologic	biologisch
biological	biologisch
biology	biologie
biopsies	biopten
bipolar	bipolaire
bird	vogel
birds	vogels
birth	geboorte
bit	beetje
black	zwarte
bladder	blaas
bladders	blazen
blastocyst	blastocyste
bleach	bleken
bleaching	bleken
bleed	aderlaten
bleed	bloeden
bleeding	bloeden
bleeding	bloeding
bleeding	bloedingen
blindness	blindheid
block	blok
block	blokkeren
blockade	blokkade
blocked	geblokkeerd
blocking	blokkeren
blood	bloed
blood	bloedafname
blood	bloedvoorziening
bloodflow	bloedstroom
bloodstream	bloedbaan
bloodstream	bloedstroom
blow	blazen
blow	klap
blow	slag
blue	blauw
blue	blauwe
blueprint	plan
bnp	bnp
body	body
boil	koken
bolus	pil
bonds	bindingen
bone	bot
bones	botten
borderline	grens
born	geboren
borrelia	borrelia
both	beiden
both	zowel
bottom	bodem
bound	gebonden
bovine	boviene
bowel	darm
brace	beugel
brace	brace
brachii	brachii
brain	hersenen
brains	hersenen
branch	tak
brand	merk
brand	merknaam
break	afbreken
break	breken
breakdown	afbreken
breaking	breken
breaks	breekt
breast	borst
breastfeeding	borstvoeding
breastmilk	moedermelk
breathe	ademhalen
breathing	ademhaling
brief	kort
briefly	kort
bright	felle
bright	helder
bright	heldere
bringing	brengen
broad	breed
broken	gebroken
brought	gebracht
brown	bruine
build	aanleggen
bulk	massa
bumps	bultjes
bundle	bundel
burden	last
burgdorferi	burgdorferi
burning	brandend
burning	branderig
burns	brandwonden
burp	boeren
business	bedrijf
busy	bezig
but	doch
but	maar
buttocks	billen
button	knoop
buy	kopen
bvd	bvd
bálint	bálint
c.	c.
c2	c2
ca	ca
caesarean	keizersnede
caffeine	cafeïne
calcification	calcificatie
calculate	berekenen
calculated	berekend
calculating	berekenen
calculus	rekening
call	heten
call	noemen
call	noemt
call	oproepen
called	genoemd
callus	eelt
calluses	eelt
caloric	warmte
calories	calorieën
can	kunnen
can	kunt
canada	canada
cancer	kanker
cancer	kankercellen
cancers	kankers
candida	candida
candidiasis	candidiasis
canker	kanker
cannulae	buisje
capabilities	mogelijkheden
capacity	capaciteit
capsules	capsules
carbamazepine	carbamazepine
carbohydrates	koolhydraten
carcinogen	kankerverwekkend
carcinogenic	kankerverwekkend
carcinoma	carcinoom
card	kaart
cardiac	cardiale
cardiac	hart
cardiopulmonary	hart
cardiovascular	cardiovasculaire
cardioversion	cardioversie
care	care
care	verzorging
careful	voorzichtig
carefully	voorzichtig
caregivers	zorgverleners
carl	carl
carotid	carotis
carries	draagt
carry	dragen
cartilage	kraakbeen
case	geval
casualty	ongeval
cataract	staar
catching	vangen
categories	categorieën
category	categorie
catheter	catheter
catheter	katheter
catheters	katheters
cats	katten
cattle	rundvee
cause	aanrichten
cause	oorzaak
cause	teweegbrengen
cause	veroorzaken
caused	veroorzaakt
causes	oorzaken
causes	veroorzaakt
cava	cava
cdp323	cdp323
cdt	cdt
cecum	blindedarm
celiac	coeliakie
cell	cell
cells	cellen
center	centrum
centrally	centraal
centre	centrum
centrifuge	centrifuge
ceramic	keramische
ceramide	ceramide
cerebellum	cerebellum
cerebral	cerebrale
cerebri	cerebri
certain	bepaald
certain	zeker
certainty	zekerheid
cervical	cervicale
chain	keten
chains	ketens
chamber	kamer
chamber	oogkamer
chance	kans
chances	kansen
change	veranderen
change	verandering
change	wijziging
changes	veranderingen
changing	wisselende
channel	kanaal
channels	kanalen
character	karakter
characteristic	karakteristiek
characteristic	karakteristieke
characteristic	kenmerkend
characteristic	kenmerkende
characteristically	typisch
characteristics	kenmerken
charged	belast
charles	charles
cheaper	goedkoper
check	controleren
checked	gecontroleerd
checking	controleren
chelation	chelatietherapie
chemical	chemisch
chemical	chemische
chemistry	chemie
chemotherapy	chemotherapie
chest	borst
chewing	kauwen
chickenpox	waterpokken
chiefly	hoofdzakelijk
childbearing	vruchtbare
childbed	kraambed
childhood	kinderleeftijd
children	kinderen
chin	kin
china	china
chinese	chinese
chlamydia	chlamydia
chlorine	chloor
choice	keus
choice	keuze
choking	verslikken
choose	kies
choose	kiest
chooses	kiest
chordates	chordadieren
chorea	chorea
chromatin	chromatine
chromosome	chromosoom
chromosomes	chromosomen
chronic	chronisch
chronic	chronische
church	kerk
circulation	bloedcirculatie
circulation	circulatie
circulation	doorbloeding
circumstances	omstandigheden
circumstances	situatie
cisgenesis	cisgenese
cities	steden
citizens	burgers
citrate	citraat
city	stad
civilians	burgers
cla	cla
class	klasse
classically	klassiek
claudication	etalagebenen
clavulanic	clavulaanzuur
clean	reinigen
clean	schoon
cleaned	gereinigd
clear	duidelijk
clients	cliënten
clinical	clinical
clinical	klinisch
clinical	klinische
clock	klok
clones	klonen
cloning	klonen
close	dicht
close	dichtbij
closed	gesloten
clot	stolsel
cloth	kleding
clothes	kleren
clothing	kleding
clotting	stolling
clubhouse	clubhuis
clubhouses	clubhuizen
clues	aanwijzingen
clumping	samenklontering
cm	cm
co	mede
coarse	grof
coated	bedekt
cochlea	slak
cognition	kennis
cold	kou
cold	koud
cold	koude
coli	coli
colitis	colitis
collaboration	samenwerking
collagen	collageen
collect	verzamelen
collected	verzameld
collecting	verzamelen
college	college
colonic	colon
color	kleur
color	kleuren
coloration	kleur
coloration	kleuring
colors	kleuren
colostomy	colostoma
colour	kleur
coma	coma
combination	combinatie
combinations	combinaties
combine	combineren
combined	gecombineerde
combining	combineren
come	gekomen
come	komen
coming	komst
coming	komt
command	bevelen
commerce	handel
commercial	commercieel
commercial	commerciële
commercially	commercieel
commission	commissie
commitment	inzet
committee	committee
common	gemeen
common	gemeenschappelijke
commonly	algemeen
communicable	overdraagbare
communication	communicatie
communications	communicatie
community	gemeenschap
comorbidities	comorbiditeit
comorbidity	comorbiditeit
compared	opzichte
comparing	vergelijken
compartment	gedeelte
compensated	vergoed
compensation	vergoeding
complement	aanvulling
complement	complement
complete	compleet
complete	complete
complete	voltooien
completed	aangevuld
completed	afgerond
complex	complex
complex	complexe
complicated	gecompliceerde
complication	complicatie
complications	complicaties
comply	voldoen
component	bestanddeel
component	component
components	componenten
components	onderdelen
composite	samengesteld
composite	samenstelling
composition	samenstelling
compound	samenstelling
compound	verbinding
compounds	verbindingen
comprehend	begrijpen
comprises	bestaat
compulsive	gedwongen
computer	computer
concentrate	concentreren
concentrated	geconcentreerd
concentrated	geconcentreerde
concentrating	concentreren
concentration	concentratie
concentrations	concentraties
conception	opvatting
concepts	begrippen
concerned	desbetreffende
concerns	zorgen
concluded	gesloten
conclusion	conclusie
conclusions	conclusies
concomitantly	gelijktijdig
concurrent	gelijktijdig
condition	staat
conditions	conditie
conduct	gedrag
conducted	uitgevoerd
conducted	verricht
conducting	uitvoeren
conduit	leiding
confer	verlenen
confined	beperkt
confirm	bevestigen
confirmed	bevestigd
confirming	bevestigen
confused	verward
congenital	aangeboren
congenital	congenitale
connected	aangesloten
connected	verbonden
connection	aansluiting
connection	verbinding
connective	bindweefsel
conscious	bewust
conscious	bewuste
consciousness	bewustzijn
consensus	consensus
consent	toestemming
consequently	zodoende
conservation	gesprek
considerable	aanmerkelijk
considerable	aanzienlijk
consist	bestaat
consisted	bestond
consisting	bestaande
consists	bestaat
constantly	voortdurend
constipation	verstopping
constituent	bestanddeel
constituents	bestanddelen
constitute	vormen
constraint	beperking
constriction	samentrekking
constrictor	sluitspier
construct	opbouwen
construction	aanleg
consult	raadplegen
consuming	consumeren
consumption	consumptie
contacts	contacten
contain	bevatten
contained	bevatte
contaminated	besmet
content	gehalte
content	inhoud
contents	inhoud
continual	voortdurend
continuous	continue
contraception	anticonceptie
contractions	samentrekkingen
contraindications	contra-indicaties
contrast	contrastmiddel
contribute	bijdragen
contributed	ingebracht
contribution	bijdrage
contributions	bijdragen
contributors	medewerkers
control	controle
conventional	conventionele
conventional	gangbare
conversation	gesprek
conversely	omgekeerd
conversion	omzetting
converted	omgezet
convinced	overtuigd
convoluted	ingewikkelde
convulsions	krampen
cook	koken
cooking	koken
coordinated	gecoördineerd
coordination	coördinatie
copd	copd
cope	omgaan
copies	kopieën
coping	omgaan
copper	koper
copy	exemplaar
copy	kopie
core	kern
corneal	hoornvlies
coronary	coronaire
correct	correct
correct	corrigeren
corrected	gecorrigeerd
correction	correctie
correctly	correct
corresponding	bijbehorende
corticosteroids	corticosteroïden
cosmetic	cosmetische
cosmetically	cosmetisch
cosmetics	cosmetica
cost	kosten
costs	kost
costs	kosten
cough	hoest
cough	hoesten
coughing	hoesten
coughs	hoest
could	kon
council	raad
count	tellen
country	land
counts	telt
couple	paar
coupled	gepaard
course	loop
course	verloop
courses	cursussen
covers	beslaat
cows	koeien
cph	cph
cpr	hartmassage
cpr	reanimaties
cream	crème
creams	crèmes
create	aanmaakt
create	aanmaken
create	creëren
created	aangemaakte
creating	creëren
creatinine	creatinine
creative	creatieve
criteria	criteria
critical	kritische
criticism	kritiek
cross	kruis
crown	kroon
crushing	breken
cry	huilen
crystal	kristal
crystal	kristallen
crystals	kristallen
csf	hersenvocht
cues	signalen
cultured	ontwikkeld
cup	cup
cup	kop
curable	genezen
cure	genezen
curettage	curettage
current	huidige
current	lopende
currently	momenteel
curved	gebogen
custom	gewoonte
customary	gebruikelijk
customized	aangepaste
cut	snee
cyanosis	cyanose
cysts	cysten
cytoplasm	cytoplasma
cytoplasmic	cytoplasma
d	d
d-dimer	d-dimeer
dag	dag
daily	daags
daily	dagelijkse
damage	beschadigen
damage	beschadiging
damaged	beschadigde
damages	beschadigingen
damaging	schadelijk
dangerous	gevaarlijk
dangerous	levensgevaarlijk
dark	donkere
darker	donkerder
dat	dat
data	gegevens
date	datum
dated	verouderd
dates	data
david	david
day	dag
days	dagen
daytime	dag
dead	dode
dead	dood
deadly	dodelijk
dealing	bezighoudt
dealing	omgang
dealt	behandeld
death	dood
death	overlijden
decades	decennia
decay	verval
deceased	overleden
decide	besluiten
decide	uitmaken
decided	bepaald
deciding	beslissen
decision	besluit
decision-making	besluitvorming
declaration	verklaring
declared	gedeclareerd
decrease	afname
decrease	verminderen
decreased	afgenomen
decreased	gedaald
decreased	verminderde
decreases	afneemt
decreases	daalt
decreases	verlaagt
deemed	geacht
deep	diep
deep	diepe
deeper	diepere
default	standaard
defecation	ontlasting
defects	defecten
defects	gebrek
defence	defensie
defense	afweer
defense	afweersysteem
deficiency	deficiëntie
deficit	tekort
deficits	uitvalsverschijnselen
define	bepalen
defined	bepaald
defined	omschreven
definite	definitief
definitely	definitief
definition	definitie
definitive	definitief
definitively	definitief
degradation	afbraak
degree	mate
degrees	graden
dehydration	uitdroging
deleterious	schadelijk
deletion	deletie
deliberately	opzettelijk
delirium	delier
delirium	delirium
deliver	leveren
delivered	geleverd
delivery	levering
delusions	wanen
demand	vraag
demand	vragen
demands	eisen
dementia	dementie
demonstrate	aantonen
demonstrated	aangetoond
demonstrating	aantonen
demonstration	demonstratie
denoted	aangeduid
denotes	geeft
dense	dicht
dental	tand
dental	tandheelkundige
dentistry	tandheelkunde
dentists	tandartsen
deoxygenated	zuurstofarme
department	afdeling
depending	afhankelijk
depends	hangt
depersonalization	depersonalisatie
der	der
dermatologist	dermatoloog
dermatology	dermatologie
dermatophytes	dermatofyten
described	beschreef
described	beschreven
describing	beschrijven
desensitization	desensibilisatie
design	opzet
designated	aangeduid
designated	aangewezen
designation	aanduiding
designation	aanwijzing
desirable	gewenst
despite	desondanks
destroyed	vernietigd
details	gegevens
detect	opsporen
detected	opgespoord
detection	detectie
detector	detector
determination	bepaling
determine	bepalen
determined	vastgesteld
developed	ontwikkeld
developed	ontwikkelde
developing	ontwikkelen
development	ontwikkeling
develops	ontwikkelt
deviations	afwijkingen
device	hulpmiddelen
devices	apparaten
devoted	besteed
dha	dha
dhāraṇā	dharana
diabetes	suikerziekte
diabetic	diabetische
diabetics	diabeten
diagnose	diagnosticeren
diagnosed	gediagnosticeerd
diagnoses	diagnoses
diagnostic	diagnostisch
diagnostic	diagnostische
diagnostics	diagnostiek
dialysis	dialyse
diameter	diameter
diaphragm	middenrif
diarrhea	diarree
diarrheal	diarree
diarrhoea	diarree
did	deed
die	sterven
died	overleed
diep	diep
dies	afsterft
dies	lijdt
dies	overlijdt
dies	sterft
dietary	dieet
dietitian	diëtist
difference	verschil
differences	verschillen
different	verschillend
different	verschillende
differently	anders
differing	uiteenlopende
differs	verschilt
difficult	lastig
difficult	moeilijk
difficult	moeilijke
difficulties	moeilijkheden
diffuse	diffuse
diffusion	diffusie
digest	verteren
digestion	spijsvertering
digestion	vertering
digitoxin	digitoxine
digits	cijfers
digoxin	digoxine
dilate	verwijden
dilute	verdund
diluted	verdund
dilutions	verdunningen
diminish	verminderen
diploid	diploïde
diploma	diploma
direct	direct
direct	directe
direct	rechtstreekse
directed	gericht
direction	richting
directive	richtlijn
directives	richtlijnen
director	directeur
dirt	vuil
dirty	vuil
disadvantages	nadelen
disappears	verdwijnt
disasters	rampen
discern	onderscheiden
discipline	vakgebied
discoloration	verkleuring
discontinued	gestaakt
discontinued	stopgezet
discourage	tegengaan
discouraged	afgeraden
discovered	ontdekt
discovered	ontdekten
discovering	ontdekken
discovery	ontdekking
discuss	bespreken
discussed	besproken
discussion	discussie
disease	aandoening
disease	disease
disease	ziektebeeld
diseases	ziekten
dishwasher	afwasmachine
disorders	stoornissen
dispersed	verspreid
display	tonen
displayed	weergegeven
disposable	beschikbaar
disposal	beschikking
disrupted	verstoord
disruption	ontwrichting
disseminated	verspreid
dissolved	opgelost
dissolving	oplossen
distal	distale
distinctive	kenmerkend
distinguish	onderscheiden
distinguishes	onderscheidt
distress	nood
distribute	verdelen
distribution	verdeling
disturb	verstoren
disturbance	stoornis
disturbed	gestoord
disturbed	verstoord
disturbing	storende
diuretics	diuretica
divergent	afwijkend
divers	verschillend
diverse	verschillend
divide	verdelen
divided	gedeeld
divided	onderverdeeld
divided	verdeeld
dividing	verdeling
division	afdeling
division	deling
division	indeling
dizziness	duizeligheid
dna	dna
do	doen
do	doet
doc	dokter
doctor	arts
doctor	dokter
doctors	artsen
doctors	dokters
documents	documenten
does	doet
dog	hond
dogs	honden
doing	doen
dominant	dominante
donate	doneren
donated	gedoneerd
done	geschiedt
donor	donor
dosage	dosering
dosages	doseringen
double	dubbele
down	af
down	beneden
down	neer
down	omlaag
dozens	tientallen
dr.	dr.
drain	drain
drained	afgevoerd
draw	putten
drawbacks	nadelen
drawn	getrokken
draws	trekt
dri	dri
dried	droog
drills	bedrijfshulpverlening
drink	drank
drinking	drinken
drinks	dranken
dro	dro
drop	druppel
dropped	gedaald
dropping	vallen
drops	druppels
drops	zakt
drowsiness	slaperigheid
dru	dru
drug	farmacon
drug	medicamenteuze
drugs	drugs
drum	trommel
dry	droge
dry	drogen
drying	drogen
dsm	dsm
ducts	leidingen
ductus	ductus
duodenal	twaalfvingerige
duodenum	duodenum
during	gedurende
dust	stof
dutch	nederlanders
dutch	nederlands
duty	dienst
dyes	kleurstoffen
dying	sterven
dysfunction	disfunctie
dyskinesia	dyskinesie
dyspnea	kortademigheid
e	e
e.g.	b.v.
each	elk
each	ieder
each	telkens
earlier	vroeger
early	vroege
early	vroegtijdig
earth	aarde
easier	gemakkelijker
easy	makkelijk
eaten	gegeten
ecg	ecg
ecthyma	ecthyma
eczema	eczeem
ed	ed
edema	oedeem
edema	zwelling
edge	rand
edta	edta
educated	geleerd
edward	edward
eeg	eeg
effect	effect
effective	effectief
effective	effectieve
effective	effectiever
effectively	effectief
effects	gevolgen
efficacy	werkzaamheid
efficiently	efficiënter
egg	ei
eggs	eieren
eggs	eitjes
egypt	egypte
eicosapentaenoic	eicosapentaeenzuur
eight	acht
either	oftewel
elastic	elastische
elbow	elleboog
elderly	bejaarden
elderly	oudere
electric	elektrisch
electrical	elektrische
electrically	elektrisch
electrodes	elektroden
electrons	elektronen
element	element
elements	elementen
elevated	verhoogd
elevation	verhoging
eliciting	uitlokken
elisa	elisa
else	anders
embolism	embolie
embryo	embryo
embryonic	embryonale
emdr	emdr
emergency	spoedeisende
emerging	opkomende
emg	emg
emitted	uitgestoten
emotion	emotie
emotional	emotioneel
emotional	emotionele
emotions	emoties
emphasis	nadruk
emphasize	benadrukken
empire	rijk
employ	dienst
employed	werknemers
employees	werknemers
employment	werk
employs	gebruikt
empty	leeg
en	en
enabled	ingeschakeld
enables	maakt
encephalopathy	encefalopathie
encompass	omvatten
encounter	ondervinden
encouraged	gestimuleerd
encourages	stimuleert
end	eind
end	einde
end	uiteinde
endemic	endemisch
ending	einde
endocrine	endocriene
endogenous	endogene
endometrium	endometrium
endoscope	endoscoop
endoscopy	endoscopie
endothelial	endotheel
endothelium	endotheel
engage	bezighouden
england	engeland
english	engels
english	engelse
enhance	verbeteren
enhanced	versterkte
enhancing	verbeteren
enlarged	vergrote
enlargement	uitbreiding
enlarging	vergroten
enormous	enorm
enormous	enorme
enough	genoeg
enough	voldoende
enquiry	onderzoek
ensue	volgen
ensuing	volgend
ensuring	zorgen
entails	inhoudt
entrance	ingang
environment	milieu
environmental	milieu
enzyme	enzym
enzymes	enzymen
epidural	ruggenprik
epithelium	epitheel
epo	epo
equal	gelijk
ernst	ernst
error	fout
erythema	erythema
erythematosus	erythematodes
erythrocyte	erytrocyten
erythropoietin	erytropoëtine
escherichia	escherichia
esophageal	slokdarm
esophagus	slokdarm
especially	name
especially	vooral
essential	essentieel
essentially	wezen
establish	vaststellen
estimation	schatting
etc	enz
etc	etc
etc.	enz
etc.	etc.
ethics	ethiek
europe	europa
european	europese
euthanasia	euthanasie
evaluation	evaluatie
evaluation	evalueren
evening	avond
event	gebeurtenis
eventual	eventueel
ever	ooit
ever	steeds
every	elk
every	iedere
everyone	iedereen
everywhere	overal
evil	kwaad
evoke	oproepen
evoked	opgeroepen
exact	exacte
exact	precieze
examine	onderzoeken
examined	onderzocht
examines	bestudeert
examines	onderzoekt
examining	onderzoeken
examples	voorbeelden
exceeded	overschreden
exception	uitzondering
excessive	excessief
excessive	overmatig
exchange	centrale
exchanged	uitgewisseld
excision	excisie
excitation	opwinding
exclusion	uitsluiting
exclusively	uitsluitend
excreted	uitgescheiden
execution	uitvoering
exercise	uitoefenen
exertion	inspanning
exist	bestaan
existed	bestond
existence	bestaan
exists	bestaat
exogenous	exogene
expanded	uitgebreid
expectation	verwachting
expected	verwacht
expects	verwacht
expelled	uitgestoten
expensive	duur
expensive	duurder
experienced	ervaren
experiences	ervaringen
experiencing	ervaren
experimental	experimenteel
experimental	experimentele
experiments	experimenten
expert	deskundige
expired	verlopen
explained	verklaard
exposure	blootstelling
express	uiten
expressed	uitgedrukt
expression	uiting
extension	uitbreiding
extensive	uitgebreid
extensively	uitgebreid
extent	omvang
exterior	buitenkant
externa	externa
external	externe
externally	uitwendig
extra	extra
extracellular	extracellulaire
extraction	extractie
extreme	extreem
extreme	extreme
extreme	uiterste
extremely	uitermate
extremity	uiteinde
eye	oog
eyelid	ooglid
eyelids	oogleden
eyesight	gezichtsvermogen
f	f
f.	f.
fabricated	vervaardigd
face	gelaat
face	gezicht
face-lifting	facelift
faced	geconfronteerd
facelift	facelift
facial	facialis
fact	feit
factitious	kunstmatig
factor	factor
factors	factoren
facts	feiten
factual	feitelijk
fail	falen
fairly	tamelijk
fall	afvallen
fall	dalen
fall	daling
fall	val
falls	valt
false	foutieve
false	onjuist
false	verkeerde
families	families
family	familie
family	gezin
far	ver
farmers	boeren
farming	landbouw
fasciculations	fasciculaties
fast	snel
fast	snelle
faster	sneller
fat	dik
fat	vet
fatal	fatale
father	vader
fatigue	vermoeidheid
fats	vetten
fault	fout
faulty	defect
favourable	gunstig
fda	fda
fear	angst
fears	angsten
featured	aanbevolen
featured	gekenmerkt
features	beschikt
features	kenmerken
features	kenmerkt
feces	ontlasting
fed	gevoed
federation	federatie
feed	aanzet
feed	voeren
feel	voelen
feeling	gevoel
feet	voeten
fellowship	gemeenschap
felt	gevoeld
female	vrouw
female	vrouwelijke
femoral	femoralis
ferment	gisten
fertile	vruchtbaar
fertile	vruchtbare
fertility	vruchtbaarheid
fetal	foetaal
fetal	foetale
fetal	foetus
fetus	foetus
few	weinig
fewer	minder
fiber	vezels
fibers	vezels
fibre	vezel
fibres	vezels
field	veld
fields	velden
fifth	vijfde
fifty	vijftig
fight	bestrijden
fight	bestrijding
fight	strijd
fight	vechten
figures	cijfers
file	bestand
filled	gevulde
filling	vulling
fillings	vullingen
film	film
filter	filter
final	definitief
final	definitieve
final	laatste
final	uiteindelijke
finally	slotte
finally	tenslotte
financial	financiële
find	bevinden
find	treft
finds	vindt
finger	vinger
fingers	vingers
fire	brand
firmly	stevig
first	eerst
first	eerste
fishes	vissen
fistula	fistel
five	vijf
fixed	vast
fixed	vastgezet
flap	klep
flat	vlak
flex	buigen
flexed	gebogen
flexion	flexie
flies	vliegen
flow	flow
flow	stromen
flowers	bloemen
flowing	stromen
flows	stroomt
flu	griep
fluid	vloeistof
fluids	vloeistoffen
fluoride	fluoride
folate	foliumzuur
fold	plooien
folic	foliumzuur
folk	mensen
follicle	follikel
follow	volgen
followed	gevolgd
following	volgend
food	eten
food	food
food	voeding
food	voedings-
food	voedsel
food	voedselbank
foods	voedingsmiddelen
foodstuffs	levensmiddelen
footwear	schoeisel
for	voor
for	wegens
forage	voer
foramen	foramen
forced	gedwongen
forceful	krachtig
forces	krachten
forearm	onderarm
forehead	voorhoofd
forensic	forensisch
foreskin	voorhuid
forgetting	vergeten
form	vorm
formally	formeel
formation	vorming
formed	gevormde
former	voormalige
forms	vormt
fortified	versterkte
forward	voren
found	geconstateerd
found	gevonden
foundation	foundation
foundation	oprichting
foundation	stichting
founded	richtte
founded	richtten
fourth	vierde
fraction	fractie
fracture	botbreuk
fracture	fractuur
fractured	gebroken
fragments	fragmenten
fragrance	geur
framework	kader
free	vrij
free	vrije
freed	vrijgemaakt
freedom	vrijheid
freely	vrij
french	frans
frequency	frequentie
frequent	frequente
frequent	veelvoorkomende
frequent	veelvuldig
frequently	frequent
frequently	vaak
frogs	kikkers
from	uit
from	van
from	vandaan
from	vanuit
front	voorste
front	voorzijde
frontal	frontale
fuel	brandstof
full	volledig
full	volledige
fully	geheel
function	functie
functional	functioneel
functional	functionele
functionally	functioneel
functioning	functionerend
functions	functioneert
fundamental	fundamentele
funded	gefinancierd
funding	financiering
fungal	schimmel
fungi	schimmels
further	verder
fusion	fusie
future	toekomst
future	toekomstige
g	g
g.	g.
gaf	gaf
gain	krijgen
gait	gang
gall	gal
gallbladder	galblaas
ganglion	ganglion
gas	gas
gases	gassen
gastric	gastric
gather	verzamelen
gave	gaf
gender	geslacht
gene	gen
general	algemeen
generalised	gegeneraliseerde
generally	algemeen
generation	generatie
generations	generaties
generic	algemeen
genes	genen
genetic	genetisch
genetically	genetisch
geneticists	genetici
genome	genoom
genus	geslacht
george	george
german	duitse
germany	duitsland
gestation	zwangerschap
get	krijgen
get	krijgt
gets	krijgt
getting	krijgen
gift	donatie
gills	kieuwen
gingiva	tandvlees
girls	meisjes
gist	kern
gives	geeft
giving	geven
glans	eikel
glass	glas
glass	glazen
glasses	bril
glaucoma	glaucoom
globally	wereldwijd
glomeruli	glomeruli
glomerulonephritis	glomerulonefritis
glomerulus	glomerulus
glycosuria	glucosurie
goal	doel
goal	doelstelling
goals	doelen
going	gaat
gold	goud
gone	weg
gonorrhea	gonorroe
good	goed
got	kregen
government	regering
gps	huisartsen
gradual	geleidelijk
grains	korrels
gram	gram
gram-positive	gram-positieve
grams	gram
grant	verlenen
granted	verleend
granules	korrels
granulocytes	granulocyten
gras	gras
grasped	begrepen
gravity	ernst
gray	grijze
great	groot
great	grote
greater	groter
greek	grieks
greek	griekse
green	groen
groin	lies
ground	grond
ground	gronden
group	groep
groups	groepen
growing	groeiende
grown	gegroeid
grown	gekweekt
grows	groeit
growth	groei
guard	bewaken
guard	wacht
guided	begeleid
guided	geleid
guideline	richtlijn
gumline	tandvlees
gums	tandvlees
gynaecology	gynaecologie
h.	h.
habit	gewoonte
habitual	gewoon
had	had
had	hadden
haematuria	hematurie
haemoglobin	hemoglobine
haemorrhagic	hemorragische
hair	haar
hairs	haren
half	half
half	halve
hallucination	hallucinatie
hand	hand
handle	handvat
handle	omgaan
hands	handen
haploid	haploïde
happen	gebeuren
happened	gebeurd
happened	gebeurde
happening	gebeurtenis
happens	gebeurt
hard	hard
hardly	nauwelijks
harmless	onschadelijk
has	heeft
have	hebt
he	hij
head	kop
headache	hoofdpijn
headaches	hoofdpijn
heal	genezen
healing	genezing
health	gezondheidsproblemen
health	gezondheidszorg
health	health
healthcare	gezondheidszorg
healthcare	zorginstellingen
healthy	gezond
heard	gehoord
heart	hart
heat	hitte
heat	warmte
heavy	zwaar
heavy	zware
height	hoogte
held	gehouden
held	hield
helium	helium
help	behulp
help	helpen
help	hulp
helped	geholpen
helpful	nuttig
helps	helpt
hemagglutinin	hemagglutinine
hematoma	hematoom
hematuria	hematurie
hemoglobin	hemoglobine
hemoglobinuria	hemoglobinurie
hemolysis	hemolyse
hemophilia	hemofilie
hemoptysis	bloedspuwing
hemorrhages	bloedingen
hemorrhagic	hemorragische
hemorrhaging	bloedingen
heparin	heparine
hepatic	lever
hepatomegaly	hepatomegalie
hepatotoxicity	hepatotoxiciteit
herbal	kruiden
herbs	kruiden
here	hier
hereditary	erfelijk
heritable	erfelijk
heroin	heroïne
herpes	herpes
herself	zichzelf
hiccups	hik
hidden	verborgen
high	high
high	hoge
high	hoog
higher	hogere
highest	hoogst
highest	hoogste
highly	zeer
him	hem
himself	zich
himself	zichzelf
hinders	belemmert
hippocrates	hippocrates
his	zijn
history	geschiedenis
hit	geraakt
hit	raakt
hit	raakte
hit	raken
hold	vasthouden
hole	gat
hollow	holle
home	thuis
homeopathic	homeopathische
homeopathy	homeopathie
hooves	hoeven
hopes	hoopt
horizontal	horizontale
hormesis	hormese
hormone	hormoon
hospital	gasthuis
hospital	hospital
hospital	ziekenhuiszorg
hot	heet
hot	hete
hot	warme
hours	uren
hours	uur
house	huis
household	huishoudelijke
how	hoe
how	hoeverre
however	echter
human	human
human	menselijk
humane	humaan
humans	mensen
humoral	humorale
hurt	pijn
husband	man
hygiene	hygiëne
hygiene	hygiënische
hygienist	mondhygiënist
hyperpigmentation	hyperpigmentatie
hypertension	hypertensie
hyperthermia	hyperthermie
hyperventilation	hyperventilatie
hypnotic	gehypnotiseerde
hypnotic	hypnotische
hypothalamic	hypothalamus
hypothalamus	hypothalamus
hypothesis	hypothese
hysteria	hysterie
ibuprofen	ibuprofen
idea	idee
ideal	ideale
identical	identiek
identified	aangemerkt
identified	gesignaleerd
identify	identificeren
idf	idf
igg	igg
igg4	igg4
ii	ii
iih	iih
iii	iii
ileum	kronkeldarm
iliac	iliaca
ill	ziek
ill	zieken
illegal	illegale
illnesses	ziekten
image	afbeelding
image	beeld
images	afbeeldingen
imaging	beeldvormend
imaging	imaging
immediately	onmiddellijk
immobilization	immobilisatie
immune	immuunreactie
immunity	immuniteit
immunologic	immunologische
immunology	immunologie
immunotherapy	immunotherapie
impacted	beïnvloed
impairing	aantasten
impairment	verslechtering
impetigo	impetigo
impetigo	krentenbaard
implant	implantaat
implantable	implanteerbare
implantation	implantatie
implementation	implementatie
important	belangrijk
important	belangrijke
impossible	onmogelijk
improper	onjuist
improved	verbeterd
improved	verbeterde
impulses	impulsen
in	in
inability	onvermogen
inactive	inactief
inadequate	onvoldoende
inadvertently	onbedoeld
inborn	aangeboren
incentives	prikkels
inception	begin
incidence	incidentie
incision	incisie
including	inclusief
income	inkomen
incontinence	urineverlies
inconvenience	ongemak
inconvenient	lastig
incorporate	nemen
incorporates	bevat
incorrect	onjuist
incorrectly	onjuist
increase	stijging
increase	toename
increase	verhogen
increase	verhoging
increase	vermeerderen
increased	toegenomen
increased	verhoogd
increases	vergroot
increases	verhoogt
increasing	toenemende
incurred	gemaakt
independent	onafhankelijk
independent	zelfstandige
independently	onafhankelijk
india	india
indicate	duiden
indicated	aangeduid
indicated	aangegeven
indicates	duidt
indication	aanwijzing
indications	indicaties
indirect	indirecte
individual	individu
individual	individueel
individuals	individuen
indomethacin	indomethacine
industry	industrie
ineffective	onwerkzaam
infant	zuigeling
infant	zuigelingenvoeding
infants	zuigelingen
infarct	infarct
infect	infecteren
infected	besmet
infected	geïnfecteerd
infecting	infecteren
infection	besmetting
infection	infectie
infections	besmettingen
infections	infecties
infectious	besmettelijk
infectivity	besmettelijkheid
inferior	inferior
infertile	onvruchtbaar
infertility	onvruchtbaarheid
inflammation	ontsteking
influence	beïnvloeden
influence	invloed
influences	invloeden
influencing	beïnvloeden
information	informatie
infrequent	zeldzaam
infusion	infuus
ingest	inslikken
ingested	ingeslikt
ingesting	inname
ingestion	inname
ingredients	bestanddelen
ingredients	ingrediënten
inguinal	lies
inguinale	inguinale
inhalation	inademing
inhalation	inhalatie
inhalational	inhalatie
inhale	inademen
inhaled	ingeademd
inheritance	overerving
inheritance	vererving
inhibition	remming
inhibits	remt
initial	aanvankelijk
initiative	initiatief
injected	geïnjecteerd
injected	ingespoten
injection	injectie
injuries	blessures
injuries	letsels
injury	letsel
inlay	inlay
insects	insecten
inside	binnen
inside	inwendige
insights	inzichten
insomnia	insomnie
insomnia	slapeloosheid
inspiration	inspiratie
instability	instabiliteit
instance	aanleg
instance	instantie
institution	instelling
institutions	instellingen
instructions	aanwijzingen
instrument	instrument
instruments	instrumenten
insufficiency	insufficiëntie
insulin	insuline
insurance	verzekering
insurance	verzekeringsplicht
insured	verzekerde
insurers	verzekeraars
intact	intact
intake	inname
intakes	inname
intelligence	intelligentie
intensity	intensiteit
intensive	intensief
intensive	intensieve
intensive	intensive
intentionally	opzettelijk
interaction	interactie
intercourse	gemeenschap
intercourse	geslachtsgemeenschap
intercourse	omgang
interest	belang
interesting	interessant
interference	interferentie
interfering	storende
intermediate	tussen
intern	intern
international	internationaal
international	international
internationally	internationaal
internet	internet
interpretation	interpretatie
interpreted	geïnterpreteerd
interrupted	onderbroken
intervene	ingrijpen
intervention	interventie
intervention	tussenkomst
interventions	ingrepen
interventions	interventies
intestinal	darm
intestine	darm
intestines	darmen
intestines	darmkanaal
intolerance	intolerantie
intracellular	intracellulaire
intractable	hardnekkige
intraocular	intra-oculaire
intravenously	intraveneus
intrinsic	intrinsic
intrinsic	intrinsieke
introduced	geïntroduceerd
introduction	introductie
introduction	invoering
investigated	onderzocht
investigating	onderzoeken
investigation	onderzoek
investigators	onderzoekers
involved	betrokken
iodine-123	jodium-123
iron	ijzer
irregular	onregelmatig
irrespective	ongeacht
irritability	prikkelbaarheid
irritation	irritatie
is	bedraagt
is	bevindt
is	is
is	wordt
ischemia	ischemie
island	eiland
isoforms	isovormen
isolated	geïsoleerd
issue	kwestie
issued	afgegeven
issues	problematiek
it	daaraan
it	eraan
it	ermee
it	ernaar
it	ervan
it	het
itching	jeuk
itchy	jeukende
itself	vanzelf
iud	spiraaltje
iuds	spiraaltjes
iv	iv
ix	ix
j.	j.
james	james
jan	januari
janet	janet
january	januari
japan	japan
japanese	japanse
jaundice	geelzucht
jaw	kaak
jaws	bek
jejunum	darm
jerks	schokken
john	john
joint	gezamenlijke
journal	journal
judge	beoordelen
judicial	gerechtelijk
july	juli
just	gewoon
just	juist
just	net
justice	justitie
juveniles	jongeren
k	k
karl	karl
keep	aanhouden
kept	bewaard
ketones	ketonen
ketonuria	ketonurie
kg	kg
kidney	nier
kill	doden
killing	doden
killing	doodt
kind	soort
kinds	soorten
klein	klein
knee	knie
knees	knieën
knife	mesje
know	kennen
know	weet
knowledge	kennis
known	bekend
known	bekende
known	bekendste
koch	koch
l	l
la	la
lab	laboratorium
labeled	gelabeld
laboratory	laboratorium
laceration	scheur
lack	ontbreken
lactating	zogende
lag	achterblijven
lake	meer
land	land
language	taal
lap	ronde
laparoscopically	laparoscopisch
laparoscopy	laparoscopie
laparotomy	laparotomie
large	groot
largely	grotendeels
larger	grotere
larva	larve
larvae	larven
laryngoscope	laryngoscoop
laser	laser
last	afgelopen
last	duren
last	laatste
lasting	durende
lasts	duurt
lateral	laterale
latest	laatste
latin	latijnse
launched	opgezet
lavender	lavendel
laws	wetten
lay	leggen
layer	laag
layers	lagen
ld	ld
le	le
leadership	leiding
leads	leidt
leaf	blad
leakage	lekkage
learned	geleerd
learning	leren
least	minste
leather	leer
leaves	verlaat
left	gelaten
left	linker
leg	been
legal	wettelijk
legally	wettelijk
legs	benen
legs	poten
leisure	vrije
lems	lems
length	lengte
leper	lepralijder
leprosy	lepra
lesions	laesies
less	minder
let	laat
lethality	letaliteit
letter	letter
leukocytes	leukocyten
leukodystrophy	leukodystrofie
level	niveau
level	peil
levels	niveaus
licensed	erkend
lichen	lichen
lidocaine	lidocaïne
life	levensjaren
life	life
life-threatening	levensbedreigende
lifelong	levenslang
lifespan	levensduur
lifestyle	levensstijl
lifetime	levensduur
lifetime	levenslang
lift	opheffen
lifted	opgeheven
ligament	ligament
light	licht
lightly	licht
like	als
likely	aannemelijk
likely	waarschijnlijk
limb	ledemaat
limbs	ledematen
limit	beperken
limitations	beperkingen
limited	beperkt
limited	beperkte
linalool	linalool
link	koppeling
link	link
link	verbinden
lipomas	lipomen
lips	lippen
liquid	vloeibare
liquid	vloeistof
liquids	vloeistoffen
list	lijst
listen	luisteren
liter	liter
literally	letterlijk
literature	literatuur
litre	liter
little	kleine
live	leven
live	levende
liver	lever
lives	leeft
lma	larynxmasker
lma	lma
load	last
loaded	geladen
loads	massa
local	lokale
local	plaatselijk
local	plaatselijke
localization	lokalisatie
localized	gelokaliseerd
locally	plaatselijk
location	ligging
location	locatie
locked	afgesloten
long	lange
long-lasting	langdurig
looked	gekeken
looks	kijkt
loose	losse
los	los
lose	verliezen
losing	verliezen
loss	verlies
losses	liezen
losses	verliezen
lost	kwijt
lot	flink
lots	veel
low	laag
low	lage
lower	dieper
lower	lager
lower	verlagen
lower	zakken
lower	zwakker
lowered	verlaagd
lowers	verlaagt
lt	lt
lumbar	lumbale
lupus	lupus
lymphocytes	lymfocyten
m.	m.
machine	machine
machinery	machines
macrophages	macrofagen
made	maakten
magnetic	magnetische
magnification	vergroting
main	belangrijkste
main	hoofd
mainly	voornamelijk
maintain	handhaven
majority	meerderheid
make	ervoor
makes	merken
making	aanmaak
malaria	malaria
malfunction	storing
malignancy	maligniteit
malignant	kwaadaardig
malignant	maligne
malnutrition	ondervoeding
mammals	zoogdieren
mammaprint	mammaprint
mammography	mammografie
managed	beheerd
management	management
mandatory	verplicht
mandible	kaak
mandible	onderkaak
mange	schurft
manifestation	manifestatie
manipulate	manipuleren
manipulation	manipulatie
mantoux	mantoux
manufactured	vervaardigd
manufacturers	fabrikanten
map	kaart
mapping	indeling
march	maart
mark	merken
markedly	aanmerkelijk
markers	merkers
market	markt
market	marktwerking
massage	massage
masses	massa
master	master
match	overeen
matching	koppeling
materia	materia
material	materiaal
matrix	voedingsbodem
matter	materie
mattress	matras
maxilla	kaak
maxillary	kaak
maximal	maximaal
maximum	maximaal
maximum	maximale
maximum	maximum
may	mei
may	mogen
meal	maal
meal	maaltijd
mean	bedoelt
mean	gemiddelde
meaning	betekenis
meaningful	belangrijk
means	betekent
means	inhoudt
means	middel
meant	bedoelde
measles	mazelen
measure	maatstaf
measured	gemeten
measurement	maat
measurement	meet
measurement	meting
measurements	metingen
measures	maatregelen
mechanical	mechanisch
mechanically	mechanisch
mechanism	mechanisme
mechanisms	mechanismen
medial	mediale
medial	middel
medic	medisch
medica	medica
medical	geneeskundig
medical	medical
medical	medisch
medically	medisch
medication	medicatie
medications	medicijnen
medicine	geneeskunde
medicine	medicament
medicines	geneesmiddelen
medicines	medicijnen
medulla	medulla
meets	voldoet
megakaryocytes	megakaryocyten
meiosis	meiose
member	lid
members	leden
membership	leden
memory	geheugen
men	mannen
mendel	mendel
meninges	hersenvlies
meninges	hersenvliezen
meningitis	hersenvliesontsteking
meningitis	meningitis
menses	menstruatie
menstruation	menstruatie
mental	mentale
mention	vermeld
meridians	meridianen
mesmerism	hypnose
messenger	messenger
metabolic	metabole
metabolism	metabolisme
metal	metalen
metallic	metalen
metals	metalen
metamorphosis	metamorfose
metastasis	metastasering
metastasis	uitzaaiing
meter	meter
method	methode
method	werkwijze
methods	methoden
metres	meter
mg	mg
micro-organisms	micro-organismen
microcephaly	microcefalie
microorganism	micro-organisme
microorganisms	micro-organismen
microscope	microscoop
microscopic	microscopische
microscopically	microscopisch
microsleep	microslaap
microsleeps	microslaap
mid	midden
middle	midden
midwife	verloskundige
migrate	migreren
migrating	migreren
mild	milde
military	leger
military	militaire
military	soldaten
million	miljoen
min	min
mind	geest
minerals	mineralen
minimal	minimaal
minimally	minimaal
minimize	verkleinen
minimum	minimum
minister	minister
ministry	ministerie
minor	minor
minute	minuut
minutes	minuten
miosis	miose
mirena	mirena
miscarriage	miskraam
mistake	fout
mistaken	verkeerd
misuse	misbruik
mite	mijt
mites	mijten
mitosis	celdeling
mixed	vermengd
mixture	mengsel
ml	ml
moderate	matig
moderately	matig
modern	moderne
modification	modificatie
modification	wijziging
modified	gemodificeerde
modify	wijzigen
moisture	vocht
molars	kiezen
mold	schimmel
molds	schimmels
molecular	moleculaire
molecules	moleculen
moment	ogenblik
monitored	bewaakt
monitoring	controle
monitors	bewaakt
monitors	monitoren
monomania	monomanie
month	maand
months	maanden
more	grotere
more	meer
more	vaker
more	verder
moreover	bovendien
moreover	overigens
morphology	morfologie
most	grootst
most	meeste
most	vaakst
mostly	meestal
mothers	moeders
motor	motorische
moulded	gegoten
mounted	aangebracht
mouth	mond
move	bewegen
movement	beweging
moving	bewegende
mris	mri
mucous	slijm
mucous	slijmvliezen
mucus	slijm
multidisciplinary	multidisciplinair
multiple	multiple
multiplied	vermenigvuldigd
multiplying	vermenigvuldigen
muscle	spier
muscle	spiermassa
muscles	oogspieren
muscles	spieren
mushrooms	paddenstoelen
music	muziek
must	moesten
must	moet
must	moeten
mutation	mutatie
mutations	mutaties
mutual	onderlinge
myasthenia	myasthenia
myelin	myeline
myelofibrosis	myelofibrose
myristic	myristinezuur
n	n
n.	n.
nails	nagels
naked	blote
named	genaamd
named	noemde
named	vernoemd
namely	namelijk
names	namen
narcotic	verdovend
narrative	narratieve
narrow	nauw
narrow	smalle
narrowing	vernauwing
nash	nash
national	nationale
nations	landen
nations	naties
natural	natural
natural	natuurlijk
natural	natuurlijke
naturally	nature
nature	natuur
nausea	misselijkheid
navel	navel
navicular	naviculare
near	dichtbij
nearly	bijna
necessarily	nodig
necessary	noodzakelijke
necessitating	noodzakelijk
necessity	noodzaak
neck	hals
neck	nek
need	behoeft
need	hoeft
need	hoeven
need	noodzaak
needed	benodigde
needed	needed
needed	nodig
needing	hoeven
needle	naald
negative	negatief
negative	negatieve
neglect	neglect
neglect	verwaarlozing
nephrectomy	nefrectomie
nephrolithiasis	nierstenen
nephrotic	nefrotisch
nerve	nervus
nerve	vagus
nerve	zenuw
nerve	zenuwbaan
nerves	zenuwbanen
nerves	zenuwen
nervosa	nervosa
network	netwerk
neural	neurale
neuralgia	neuralgie
neurologic	neurologisch
neurological	neurologische
neurologist	neuroloog
neurology	neurologie
neuromuscular	neuromusculaire
neuromyotonia	neuromyotonie
neurons	zenuwcellen
neuropathy	neuropathie
neuropsychiatry	neuropsychiatrie
neurotransmitter	neurotransmitter
nevertheless	toch
new	nieuw
newborn	pasgeborene
newest	nieuwste
news	nieuws
newts	salamanders
next	volgend
next	volgende
nighttime	nacht
niyama	niyama
nnt	nnt
nocturnal	nachtelijke
non	niet
noninvasive	niet-invasieve
norm	norm
normally	gewoonlijk
normally	normaliter
norms	normen
norway	noorwegen
nose	neus
notable	opvallend
noted	bekend
nothing	niets
noticeable	merkbaar
notion	begrip
november	november
nowadays	tegenwoordig
nucleotides	nucleotiden
numb	verdoofd
number	getal
numbers	aantallen
numbness	verdoving
nurse	verpleegkunde
nursing	verpleging
nutrient	voedingsstof
nutrients	nutriënten
nutrition	voeding
nuts	noten
nystagmus	nystagmus
o	o
oas	oas
obesity	obesitas
object	voorwerp
objections	bezwaren
objectives	doelen
objects	voorwerpen
observation	observatie
observation	waarneming
observed	opgemerkt
observed	waargenomen
observing	observeren
obstetrical	verloskundige
obstetrician	verloskundige
obstruction	obstructie
obstructive	obstructieve
obtained	verkregen
obtaining	verkrijgen
obvious	duidelijk
occupy	bezighouden
occur	voordoen
occurring	voorkomend
occurs	optreedt
occurs	treedt
october	oktober
odd	vreemd
odor	geur
oesophagus	slokdarm
of	van
offer	aanbieden
offer	aanbod
offer	bieden
offers	biedt
official	officiële
offset	compenseren
often	dikwijls
often	vaak
often	veelal
oil	olie
oil	oliën
ointment	zalf
old	oud
old	oude
omitted	achterwege
on	erop
on	inzake
once	eenmaal
once	eens
oncologist	oncoloog
one	een
one	ene
ones	degenen
oneself	zichzelf
only	alleen
only	pas
only	slechts
onset	begin
onwards	verder
oocytes	oöcyten
open	open
opened	geopend
openehr	openehr
opening	opening
opens	uitmondt
operated	geopereerd
operates	opereert
operation	ingreep
operation	operatie
operation	werking
operational	operatief
operations	operaties
operations	verrichtingen
operculum	operculum
opinions	adviezen
opportunities	mogelijkheden
opportunity	kans
opposite	tegenover
oppositional	tegenovergestelde
optical	optische
option	keuze
option	optie
optometrist	optometrist
optometry	optometrie
or	of
oral	orale
orbit	oogkas
order	orde
order	volgorde
ordered	verwezen
ordinarily	gewoonlijk
ordinary	gewone
ordinary	gewoon
oregon	oregon
organ	orgaan
organic	biologische
organic	organisch
organic	organische
organism	organisme
organization	organisatie
organizations	organisaties
organs	organen
orifice	opening
orifices	openingen
origin	herkomst
origin	oorsprong
original	oorspronkelijke
originates	afkomstig
originating	afkomstig
originating	oorsprong
origins	oorsprong
orthodontic	orthodontische
orthodontics	orthodontie
orthodontist	orthodontist
osteoporosis	osteoporose
other	ander
other	anders
others	anderen
otherwise	anders
our	onze
out	eruit
out	uit
outbreak	uitbraak
outcome	outcome
outcomes	uitkomsten
outer	buitenste
outermost	buitenste
outlook	vooruitzichten
outpatient	ambulante
outside	buiten
outside	uitwendige
over	beëindigd
overall	algehele
overall	algemene
overall	totale
overdose	overdosering
overdose	overdosis
overload	overbelasting
ovulation	ovulatie
ovum	eicel
own	bezitten
oxygen	zuurstofarm
oxygenated	zuurstofrijk
p	p
pa	vader
pace	tempo
pacing	stappen
package	pakket
padding	vulling
paid	betaald
pain	pijn
pain	pijnklachten
painful	pijnlijke
palate	gehemelte
pale	bleek
pale	bleke
palliative	palliatieve
pallidum	pallidum
palpation	palpatie
pancreas	alvleesklier
panic	paniek
papers	stukken
paraganglioma	paragangliomen
paragangliomas	paragangliomen
parallel	parallel
paralysis	verlamming
paralyzed	verlamd
paramedics	paramedici
parasite	parasiet
parasites	parasieten
parasitic	parasitaire
parasympathetic	parasympathische
parent	ouder
parenteral	parenterale
parents	ouders
paresthesia	paresthesie
parietal	pariëtale
paris	parijs
parkinson	parkinson
parkinsonian	parkinson
pars	pars
part	aandeel
part	deel
part	gedeelte
part	onderdeel
part	uitmaakt
partial	partiële
partially	dele
participation	deelname
particular	bijzonder
particularly	vooral
particulates	deeltjes
partner	partner
parts	onderdelen
parturition	bevalling
pass	doorlaat
pass	overgaan
passed	doorgegeven
passive	passief
past	voorbij
pathogen	pathogeen
pathogen	ziekteverwekker
pathogens	pathogenen
pathogens	ziekteverwekkers
pathologic	pathologische
pathological	pathologisch
pathology	pathologie
patient	patient
patient	patiënt
patient	zieke
patients	patiënten
pay	betalen
pectoris	pectoris
peel	schil
peg	peg
pelvis	bekken
penetrate	binnendringen
penetrates	binnendringt
penicillin	penicilline
penis	penis
people	personen
perceive	waarnemen
perceived	waargenomen
percent	procent
percentage	percentage
perforation	perforatie
performance	uitvoering
performed	uitgevoerd
perhaps	misschien
perinatal	perinatale
period	menstruatie
period	periode
periodically	periodiek
periods	perioden
periods	periodes
peripheral	perifeer
peripheral	perifere
peristalsis	peristaltiek
peritoneal	peritoneale
peritoneum	peritoneum
permanent	blijvende
permanent	permanente
permitted	toegestaan
person	betrokkene
person	persoon
personal	persoonlijk
personal	persoonlijke
personality	persoonlijkheid
personally	persoonlijk
personnel	personeel
persons	personen
pertaining	behorende
petechial	petechiën
ph	ph
pharmaceutical	farmaceutische
pharmacists	apothekers
pharmacopoeia	farmacopee
pharmacopoeias	farmacopee
pharmacy	apotheek
pharynx	farynx
pharynx	keelholte
phase	fase
phases	fasen
phenomena	verschijnselen
phenomenon	fenomeen
phenomenon	verschijnsel
philosophy	filosofie
phlebectomy	flebectomie
phlebotomy	aderlaten
phone	telefoon
phosphate	fosfaat
phospholipids	fosfolipiden
phrases	zinnen
physical	lichamelijke
physically	fysiek
physician	arts
physicians	artsen
physiologic	fysiologisch
physiologically	fysiologisch
physiology	fysiologie
picture	beeld
pictures	afbeeldingen
pictures	beelden
pictures	plaatjes
piece	stuk
pieces	stukjes
pieces	stukken
pierre	pierre
pigment	kleurstof
pigment	pigment
pill	pil
pinch	knijpen
pink	roze
pituitary	hypofyse
place	plaats
place	plaatsen
place	plaatsgevonden
placement	plaatsing
placenta	placenta
placental	placenta
plague	pest
plan	plannen
plane	vlak
plant	plant
plants	planten
plaque	plaque
plasmin	plasmine
plastic	kunststof
plate	plaat
platelet	bloedplaatjes
platelets	bloedplaatjes
platelets	trombocyten
platform	platform
plausible	aannemelijk
playing	spelen
plays	speelt
pleural	meervoud
pleural	pleuravocht
plexus	plexus
plural	meervoud
podiatrist	podoloog
podiatrist	podotherapeut
podiatrists	podotherapeuten
podiatry	pedicure
podiatry	podotherapie
point	punt
points	punten
points	wijst
poison	gif
poisoning	vergiftiging
poisons	vergiften
police	politie
policy	beleid
polish	poetsen
political	politieke
polycythemia	polycythaemia
polycythemia	polycythemie
polydipsia	polydipsie
polyps	poliepen
polyuria	polyurie
poor	slechte
poorly	slecht
popliteal	poplitea
popularity	populariteit
population	bevolking
population	populatie
porcelain	porselein
porcine	varkens
portion	deel
position	positie
positions	posities
positive	positief
positive	positieve
positively	positief
possessing	bezit
possibility	mogelijkheid
possible	mogelijk
possibly	mogelijk
post	post
posterior	posterior
posture	houding
potency	sterkte
potential	eventueel
potential	potentieel
potential	potentiële
potter	potter
powder	poeder
power	kracht
power	vermogen
power	vermogens
powered	aangedreven
powerful	krachtig
powers	bevoegdheden
practical	praktisch
practically	bijna
practice	praktijk
practised	beoefend
pratyahara	pratyahara
preceded	voorafgegaan
preceding	voorafgaande
precisely	precies
precursor	voorloper
predict	voorspellen
predisposition	aanleg
prefrontal	prefrontale
pregnancies	zwangerschappen
pregnant	zwanger
pregnant	zwangere
preparation	bereiding
preparations	preparaten
prepared	bereid
prepared	geprepareerd
prescribe	voorschrijven
prescribing	voorschrijven
prescription	voorschrift
present	aanwezige
press	drukken
pressures	druk
presumably	vermoedelijk
prevalence	prevalentie
preventing	voorkomen
prevention	preventie
prevention	voorkoming
preventive	preventieve
prevents	voorkomt
previous	eerdere
previous	voorgaande
previous	vorige
previously	eerder
prey	prooi
price	prijs
prick	prikken
primarily	allereerst
primary	primaire
primary	voornaamste
prime	eerste
primordial	oorspronkelijk
primordial	primordiale
principally	hoofdzakelijk
principle	principe
print	afdruk
print	gedrukt
prions	prionen
prior	voorafgaand
priority	prioriteit
privacy	privacy
prize	prijs
probable	waarschijnlijke
probably	vermoedelijk
probe	sonde
problematic	problematisch
procedure	procedure
procedures	procedures
proceed	doorgaan
proceedings	werkzaamheden
process	verwerken
process	werkwijze
processed	verwerkt
processes	processen
processing	verwerking
produce	produceren
produced	geproduceerd
producers	producenten
product	artikel
product	product
production	productie
products	producten
profession	beroep
professional	beroepsmatige
professional	professional
professions	beroepen
professor	professor
profile	profiel
profound	ingrijpende
program	programma
programme	programma
progression	progressie
progressive	progressief
progressive	progressieve
prohibited	belemmerde
prohibited	verboden
project	project
projects	projecten
prolactinoma	prolactinoom
proliferation	woekering
prolonged	langdurig
promotion	bevordering
prompted	gevraagd
prone	vatbaar
proof	bewijs
propagation	voortplanting
propensity	neiging
properly	behoorlijk
property	eigenschap
propofol	propofol
proponents	voorstanders
proposed	voorgesteld
prostate	prostaat
prostheses	prothesen
protected	beschermd
protection	beschermende
protection	bescherming
protein	eiwit
protein	protein
protein	proteïne
proteins	eiwitten
proteins	proteïnen
proteinuria	proteïnurie
prothrombin	protrombine
protocol	protocol
prove	aantonen
prove	bewijzen
prove	blijken
provide	voorzien
provides	biedt
provides	voorziet
proving	bewijzen
provisions	voorzieningen
provoked	uitgelokt
psychasthenia	psychasthenie
psychiatrists	psychiaters
psychological	psychologisch
psychological	psychologische
psychosis	psychose
psychotherapy	psychotherapie
pta	pta
puberty	puberteit
publicity	bekendheid
pulled	getrokken
pulling	trekken
pulls	trekt
pulmonary	long
pulmonary	pulmonaire
pulmonary	pulmonale
pulse	pols
pump	pomp
pupillary	pupil
pure	zuivere
purified	gezuiverd
purpose	doel
purposes	doeleinden
purpura	purpura
pus	etter
push	dringen
pushed	geschoven
pustules	pustels
put	gezet
quality	kwaliteit
quantitative	kwantitatieve
quantities	hoeveelheden
quantity	hoeveelheid
questions	vragen
quick	snel
quicker	sneller
quickly	snel
quite	heel
radioactive	radioactief
radioactive	radioactieve
radiologist	radioloog
radiotherapy	radiotherapie
radius	spaakbeen
raise	verhogen
random	toevallig
random	willekeurig
randomly	willekeurig
range	reeks
range	scala
ranula	ranula
rapidly	snel
rare	zeldzame
rarely	zelden
ras	ras
rash	huiduitslag
rate	tarief
rates	tarieven
rather	liever
ratio	ratio
ratio	verhouding
rdw	rdw
reach	bereiken
reached	bereikt
reaching	bereiken
read	afgelezen
read	lezen
ready	gereed
real	echt
real	echte
reality	realiteit
realize	realiseren
really	echt
really	werkelijk
rear	kweken
reasonably	redelijk
reasons	redenen
rebound	rebound
receive	ontvangen
received	gekregen
receiver	ontvanger
recent	recente
receptors	receptoren
recessive	recessief
recipe	recept
recognised	erkend
recognition	erkenning
recognizable	herkenbaar
recognized	herkend
recognizing	herkennen
recombinant	recombinant
recommended	aanbevolen
recommended	aangeraden
recommending	bevelen
recommends	raadt
record	opnemen
recorded	vastgelegd
recordings	opnames
recover	herstellen
recovers	herstelt
recovery	herstel
rectum	endeldarm
recur	terugkeren
red	rode
red	rood
redness	roodheid
reduce	verminderen
reduced	verlaagd
reduced	verlaagde
reduced	verminderd
reduced	verminderde
reducing	vermindering
reduction	reductie
reduction	verlaging
reduction	vermindering
referred	genoemd
refined	gezuiverd
reflex	reflex
reflexes	reflexen
reflux	reflux
regimen	dieet
region	regio
regional	regionaal
register	register
register	registreren
registered	geregistreerd
registration	registratie
regular	regelmatig
regularly	regelmatig
regulate	reguleren
regulates	regelt
regulations	regelgeving
regulations	wettelijke
rehabilitative	revalidatie
reimbursement	vergoeding
reinforced	versterkte
reinforces	versterkt
relate	vertellen
related	gerelateerde
related	verwante
relation	betrekking
relation	relatie
relative	relatieve
relatively	relatief
relatives	familie
relaxation	ontspanning
release	afgifte
release	loslaten
released	vrijkomt
reliability	betrouwbaarheid
reliable	betrouwbaar
reliably	betrouwbaar
reliance	vertrouwen
relieve	helpen
religious	religieus
relying	vertrouwen
remain	blijven
remainder	overige
remaining	overgebleven
remains	achterblijft
remarkable	opvallende
remember	herinneren
remember	onthouden
removal	verwijdering
remove	verwijderen
removed	verwijderd
removing	verwijderen
repeat	herhalen
repeat	herhaling
repeating	herhalen
repetition	herhaling
replaced	vervangen
report	melden
report	rapport
representation	voorstelling
repressed	onderdrukt
request	verzoek
required	nodig
required	vereiste
requirements	eisen
research	onderzoek
research	research
researcher	onderzoeker
researches	onderzoeken
researching	onderzoeken
resident	aios
residual	overgebleven
residues	resten
resist	weerstand
resistance	resistentie
resolve	oplossen
resolved	opgelost
resorbed	geresorbeerd
resorption	resorptie
respect	aanzien
respiratory	luchtwegen
responds	reageert
response	antwoord
response	respons
responses	reacties
responsibility	verantwoordelijkheid
responsible	verantwoordelijk
restoration	restauratie
restore	herstellen
restored	hersteld
restricting	beperken
restriction	beperking
restrictions	beperkingen
rests	berust
result	resulteren
result	uitkomst
resulting	ontstane
results	resultaten
results	resulteert
resuscitation	reanimatie
retain	behouden
retained	vastgehouden
retardation	retardatie
reticulum	netmaag
reticulum	reticulum
retrieve	terugvinden
return	terugkeer
return	terugkomen
returning	terugkerende
returns	terugkomt
reused	hergebruikt
revealed	gebleken
reverse	omgekeerde
reversed	omgekeerd
reversible	reversibel
reviewed	beoordeeld
revised	herzien
rhythmic	ritmisch
ribs	ribben
rice	rijst
rich	rijk
right	correct
right	rechts
rigidity	stijfheid
rim	rand
rinderpest	runderpest
ring	ring
ringworm	ringworm
rinse	spoelen
rinsed	gespoeld
rinsing	spoelen
rises	stijgt
rising	opstijgende
rising	stijgende
risk	risico
rna	rna
road	weg
robert	robert
role	rol
room	kamer
root	wortel
rose	nam
roughly	ongeveer
round	ronde
royal	koninklijke
rpgn	rpgn
rubbing	wrijven
rubella	rodehond
rule	regel
rumen	maag
ruminal	pens
ruminants	herkauwers
run	doorlopen
runny	vloeibaar
runs	loopt
rupture	ruptuur
rupture	scheuring
ruptured	gescheurde
s.	s.
safe	veilig
saline	zoutoplossing
salt	zouten
salts	zouten
same	dezelfde
same	hetzelfde
sample	monster
saphenous	vena
sarcoidosis	sarcoïdose
satisfied	voldaan
satisfy	voldoen
saturated	verzadigd
save	behouden
save	opslaan
saved	bewaard
saved	opgeslagen
says	zegt
scale	schaal
scales	balans
scan	scan
scarring	littekens
scars	littekens
schedules	schema
scholar	geleerde
school	school
science	kunde
science	wetenschap
scientific	wetenschappelijk
scientific	wetenschappelijke
scientists	wetenschappers
scintigraphy	scintigrafie
sclerosis	sclerose
score	scoren
scottish	schotse
scratching	krabben
screening	screenen
screening	screening
se	se
seal	afsluiting
searching	zoeken
seated	zittende
second	tweede
secondarily	secundair
secondary	tweede
seconds	seconden
secretion	uitscheiding
section	doorsnede
section	vak
secure	fixeren
securely	vast
security	veiligheid
security	veiligheidsmaatregelen
sedated	verdoofd
sedation	verdoving
sedatives	sedativa
see	bekijken
see	zie
see	zien
seeds	zaden
seem	lijken
seen	gezien
segment	segment
seldom	zelden
select	kiezen
select	selecteren
selected	gekozen
selecting	selecteren
selective	selectief
selectively	selectief
self	zelf
self-healing	zelfgenezend
send	sturen
sense	zin
sensitive	gevoelige
sensitive	gevoeliger
sensitivity	gevoeligheid
sensitivity	sensitiviteit
sentence	zin
sentences	zinnen
separate	scheiden
separating	scheiden
separation	scheiding
sepsis	sepsis
septal	septum
september	september
septum	septum
series	reeks
series	serie
serious	ernstige
seriously	ernstig
serologic	serologische
serological	serologische
serotonin	serotonine
serum	serum
serve	dienen
services	diensten
session	sessie
sessions	sessies
set	ingesteld
set	stel
set	stellen
set	voorgeschreven
setting	omgeving
seven	zeven
sevoflurane	sevofluraan
sex	geslacht
sex	seks
sexual	seksueel
sexually	seksueel
shaking	schudden
shape	vorm
shaped	gevormd
shaped	gevormde
shapes	vormen
share	delen
sharp	scherp
she	ze
sheep	schapen
shell	omhulsel
shock	schok
shock	shock
shoes	schoenen
short	kort
short	kortdurende
short	korte
short-term	kortdurend
shortage	schaarste
shorter	korter
should	dient
should	moeten
shoulders	schouders
show	blijkt
showed	liet
showed	toonde
shower	douche
shower	douchen
showing	tonen
shunt	shunt
shunts	shunts
sickness	ziekte
side	zijde
side	zijkant
side-effect	bijwerking
sight	zicht
sign	teken
signal	signaal
significance	betekenis
significantly	aanzienlijk
significantly	beduidend
significantly	significant
signs	tekenen
silent	stil
similar	soortgelijk
similarities	overeenkomsten
simple	eenvoudig
simple	eenvoudige
simple	simpel
simultaneously	gelijktijdig
since	sindsdien
sinus	sinus
site	plaats
sites	plaatsen
sites	plekken
sits	zit
situated	gelegen
situation	situatie
situations	situaties
six	zes
sixth	zesde
size	grootte
size	maat
sized	grootte
skeleton	skelet
skin	huid
skull	schedel
sleep	slaap
sleepiness	slaperigheid
slight	gering
slow	langzaam
slow	traag
slowing	vertragen
slowly	langzaam
slows	vertraagt
small	klein
smaller	kleinere
smallest	kleinste
smallpox	pokken
smell	ruiken
smith	smith
smoking	roken
smooth	gladde
snail	slak
snakes	slangen
sneezing	niezen
snoring	snurken
so	dus
so-called	z.g.
so-called	zogenaamd
so-called	zogenoemde
soap	zeep
social	maatschappelijke
social	sociaal
social	sociale
societal	maatschappelijke
society	maatschappij
society	samenleving
society	society
sodium	natrium
soft	zacht
soil	bodem
sold	verkocht
solely	alleen
soles	voetzolen
soluble	oplosbare
solution	oplossing
solutions	oplossingen
solve	oplossen
solving	oplossen
some	bepaalde
some	enige
some	sommigen
some	zekere
something	iets
sonic	sonische
soon	drä
soon	spoedig
sophisticated	geavanceerde
sore	zeer
sores	blaasjes
sores	zweren
sos	sos
sought	getracht
sound	degelijk
sounds	geluiden
sources	bronnen
spain	spanje
spanish	spaanse
spatial	ruimtelijke
speak	spreken
special	bijzonder
special	speciaal
specialist	specialistische
specialization	specialisatie
specialize	specialiseren
specialized	gespecialiseerd
specially	speciaal
species	diersoorten
specific	specifiek
specific	specifieke
specifications	bestek
spect	spect
spectacles	bril
sperm	sperma
sperm	spermacel
sphincter	kringspier
spiritual	geestelijk
spirometer	spirometer
spirometry	spirometrie
spleen	milt
spontaneous	spontaan
spontaneously	spontaan
spoon	lepel
spores	sporen
sport	sport
sports	sporten
spot	plek
spots	vlekken
spray	spray
spread	verspreiden
spread	verspreiding
spreading	verspreidt
spring	ontspringen
squeezing	knijpen
st	st
stable	stabiel
staff	personeel
staff	stafleden
stage	stadium
stain	vlek
stairs	trap
stance	houding
stand	staan
stand	stand
standard	standaard
standard	standard
standards	normen
standing	staande
staphylococcus	staphylococcus
starch	zetmeel
start	begin
started	begon
started	gestart
started	startte
state	staat
state	toestand
stated	bepaald
statement	verklaring
states	bepaalt
states	staten
states	verklaart
stating	stellen
status	status
status	toestand
stay	blijven
stay	verblijf
stay	verblijven
staying	verblijven
stays	verblijven
steady	vast
steel	stalen
stem	stam
stenoses	vernauwingen
stenosis	stenose
stent	stent
step	stap
step	treden
steps	stappen
sterile	steriele
sternal	borstbeen
sternum	borstbeen
stick	kleven
still	nog
stimulates	stimuleert
stimulating	stimulerende
stimulation	stimulatie
stimulus	prikkel
stimulus	stimulus
stings	steken
stoma	stoma
stomach	maag
stomach	maagwand
stomatitis	stomatitis
stone	niersteen
stone	steen
stood	stond
stool	ontlasting
stopped	gestopt
stopping	stoppen
stories	verhalen
story	verhaal
straight	recht
straining	inspanning
stream	stroom
strength	kracht
strength	sterkte
strengthen	versterken
strep	streptokokken
streptococcus	streptococcus
stress	spanning
stresses	spanningen
stressful	belastend
strict	strenge
strict	strikt
strictly	strikt
stricture	vernauwing
strictures	vernauwingen
strike	staken
string	draad
strip	strip
stroke	herseninfarct
strokes	beroertes
stronger	sterker
stronger	sterkere
studies	studies
study	studie
studying	bestuderen
stupor	verdoving
subarachnoid	subarachnoïdale
subclavian	subclavia
subcutaneous	subcutane
subject	onderwerp
subject	proefpersoon
subsequently	nadien
subsequently	vervolgens
substance	stof
substance	substantie
substances	stoffen
substituted	vervangen
succeed	lukt
succeeded	geslaagd
successful	succesvol
successful	succesvolle
successfully	geslaagd
successive	opeenvolgende
such	dergelijke
suddenly	plotseling
suffering	lijden
suffers	lijdt
sugars	suikers
suitable	geschikt
suitable	geschikte
summary	overzicht
superficial	oppervlakkig
superior	superior
supervised	toezicht
supervision	toezicht
supplementary	aanvullend
supplementation	suppletie
supplemented	aangevuld
supplied	geleverde
supplied	ingevoerd
suppliers	leveranciers
supply	aanvoer
supply	leveren
supply	levering
supply	toevoer
support	steun
support	support
supported	ondersteund
supporters	voorstanders
supporting	ondersteunende
supportive	ondersteunende
supports	ondersteunt
supposed	verondersteld
suppressed	onderdrukt
suppression	onderdrukking
surface	oppervlak
surface	oppervlakte
surgeons	chirurgen
surgeries	operaties
surgery	chirurgie
surgery	heelkunde
surgery	heelkundige
surgical	chirurgische
surgically	operatief
surround	omgeven
surrounded	omgeven
surrounding	omliggend
surrounding	omliggende
surroundings	omgeving
surveillance	bewaking
surveillance	toezicht
survival	overlevingskans
survive	overleven
suspect	verdacht
suspicion	verdenking
suspicious	verdacht
suture	hechten
suture	hechting
sutured	gehecht
suturing	hechten
swallow	inslikken
swallow	slikken
swallowing	slikken
sweat	zweten
sweden	zweden
swelling	zwelling
swim	zwemmen
swiss	zwitserse
switch	schakelen
symbol	symbool
symmetric	symmetrisch
sympathetic	sympathische
symptom	symptoom
symptomatic	symptomatische
symptoms	symptomen
synapses	synapsen
syncope	syncope
syndrome	syndroom
syndromes	syndromen
syndromes	ziektebeelden
synonymous	synoniem
synonymously	synoniem
synthesis	synthese
synthesized	gesynthetiseerd
syphilis	syfilis
system	stelsel
system	systeem
systematic	systematisch
systematic	systematische
systems	systemen
t.	t.
table	tabel
tablet	tablet
tablets	tabletten
tail	staart
take	aannemen
take	afnemen
take	innemen
take	nemen
taken	ingenomen
takes	duurt
taking	inneming
taking	nemen
tap	leidingwater
tardive	tardieve
target	doel
targeted	doelgericht
targeted	gerichte
tarsometatarsus	tarsometatarsus
task	taak
taste	smaak
tea	thee
teaching	onderwijs
team	team
tear	scheur
technical	technisch
technique	techniek
techniques	technieken
technology	technologie
telephone	telefoon
temperature	temperatuur
temporarily	tijdelijk
temporary	tijdelijk
tendency	neiging
tendon	pees
tension-type	spanningshoofdpijn
terbinafine	terbinafine
term	termijn
terminal	terminale
terminates	eindigt
terms	termen
territory	gebied
test	test
tested	getest
testing	testen
tests	testen
tests	tests
tetracycline	tetracycline
texture	structuur
than	dan
that	die
the	de
the	het
the	the
then	dan
then	vervolgens
theoretical	theoretische
theory	theorie
therapeutic	therapeutisch
therapeutic	therapeutische
therapeutics	therapie
therapies	therapieën
therapist	therapeut
therapy	therapie
there	daaruit
there	er
there	sprake
therefore	daarom
therefore	derhalve
these	deze
these	zulke
they	ze
they	zij
thick	dik
thick	dikke
thickness	dikte
thin	dunne
things	dingen
think	denken
think	menen
thinner	thinner
thinning	verdunnen
third	derde
thirty	dertig
this	dit
this	hiervoor
thorax	thorax
thorough	grondig
thoroughly	grondig
those	degenen
though	hoewel
thought	dacht
thought	gedacht
thoughts	gedachten
thousand	duizend
thousands	duizenden
threatened	bedreigde
threatening	bedreigend
threshold	drempel
thrombin	trombine
thrombocytopenia	trombocytopenie
thrombocytosis	trombocytose
thrombolysis	trombolyse
thrombophilia	trombofilie
thrombophilias	trombofilie
thrombosis	trombose
thrombus	trombus
through	door
through	doorgemaakt
through	doorheen
through	middels
throughout	overal
thus	aldus
thus	dus
thyroid	schildklier
tia	tia
tibia	scheenbeen
tibial	tibiale
tied	gebonden
tight	strak
tightly	strak
till	tot
time	keer
time	tijd
tingling	tintelingen
tiredness	vermoeidheid
title	titel
tnm	tnm
to	aan
to	naar
to	om
to	ter
to	to
to	toe
today	heden
toe	teen
toes	tenen
together	samen
too	te
took	duurde
took	nam
toothpaste	tandpasta
top	top
torn	gescheurde
touch	tast
tough	harde
tourniquet	tourniquet
town	gemeente
town	stad
toxic	giftig
toxic	giftige
toxicity	toxiciteit
toxins	toxines
tracer	tracer
traces	sporen
trachea	trachea
tract	tractus
traction	tractie
traditional	traditioneel
traditional	traditionele
train	trainen
trained	getraind
training	opleiding
training	opleidingen
training	trainingen
traits	eigenschappen
transcortical	transcorticale
transferred	overgebracht
transferred	overgedragen
transformation	gedaanteverwisseling
transfusion	transfusie
transient	voorbijgaande
translated	vertaald
transmissible	overdraagbaar
transplantation	transplantatie
transport	transport
transport	transporteren
transport	vervoeren
transported	getransporteerd
transported	vervoerd
transports	vervoert
trapped	vastzitten
trauma	trauma
traumatic	traumatische
treat	behandelen
treat	treat
treatable	behandelbaar
treated	behandeld
treated	behandelde
treating	behandelen
treatment	behandeling
treatment	kuur
treatments	behandelingen
trend	trend
treponema	treponema
triage	triage
trial	proces
trichomoniasis	trichomoniasis
tried	geprobeerd
triggered	veroorzaakt
triglycerides	triglyceriden
trouble	moeite
troublesome	lastig
true	waar
true	ware
try	trachten
trying	proberen
tryptophan	tryptofaan
tube	buis
tube	slangetje
tuberculin	tuberculine
tuberculosis	tuberculose
tuberculosis	tuberculosis
tubing	buis
tubular	tubulaire
tubules	tubuli
tumor	gezwel
tumor	tumor
tumors	tumoren
tumours	tumoren
turn	beurt
turn	keren
turn	wisseling
turned	gedraaid
turning	draaien
turns	bochten
twelve	twaalf
twentieth	twintigste
twenty	twintig
type	type
type	typen
types	types
typical	typisch
typically	typisch
u	u
ulcer	ulcus
ulcer	zweer
ulcerated	zweren
ulcers	ulcera
ulna	ellepijp
ulnar	ulnaire
ultimately	tenslotte
ultrasonography	echografie
ultrasound	echografie
umbilicus	navel
unclear	onduidelijk
uncomplicated	eenvoudig
unconscious	onbewuste
unconsciousness	bewusteloosheid
under	onder
underestimated	onderschat
undergo	ondergaan
undergoes	ondergaat
undergoing	ondergaat
underlying	onderliggende
understand	begrijpen
understanding	begrip
understands	begrijpt
understood	begrepen
undiagnosed	gediagnosticeerd
unfortunately	helaas
union	unie
unit	eenheid
united	verenigd
units	eenheden
university	academisch
university	universiteit
unknown	onbekend
unless	tenzij
unlikely	onwaarschijnlijk
unnecessary	onnodig
unpleasant	onaangenaam
unsaturated	onverzadigde
unstable	instabiel
until	tot
until	totdat
untreated	onbehandeld
unusually	ongewoon
unwanted	ongewenste
up	liefst
up	omhoog
upon	op
upright	rechtop
urea	ureum
ureter	urineleider
urethra	plasbuis
urethra	urethra
urethra	urinebuis
urge	drang
urinary	urine
urinating	urineren
urination	urineren
urine	urine
us	ons
usage	gebruik
use	gebruik
used	aangewend
used	gebruikgemaakt
used	gebruikt
used	gebruikte
useful	nuttig
uses	hanteert
uses	toepassingen
usual	gebruikelijk
usually	gewoonlijk
utero	baarmoeder
uterus	uterus
vaccinated	gevaccineerd
vaccination	vaccinatie
vaccine	vaccin
vacuum	vacuüm
vagina	vagina
valuable	waardevolle
value	waarde
values	waarden
valve	klep
valves	kleppen
vapor	damp
vapor	dampen
variant	variant
variation	variatie
varicose	spataderen
varied	afwisselend
varies	varieert
variola	variola
various	allerlei
variously	verschillend
vary	variëren
vascular	vasculaire
vasoconstriction	vasoconstrictie
vast	groot
vegetable	plantaardige
vegetables	groenten
vein	ader
vein	aderen
vein	vene
veins	aderen
veins	aders
veins	venen
velocity	snelheid
velopharyngeal	velofaryngeale
vena	ader
vena	vena
venae	venae
venipuncture	venapunctie
venous	veneuze
ventilated	beademd
ventilation	ventilation
ventricle	ventrikel
version	versie
vertebra	wervel
vertebrae	wervels
vertebral	wervel
vertebrate	gewervelde
vertebrates	gewervelden
vertigo	duizeligheid
very	erg
vesicles	blaasjes
vessel	vaatwand
vet	dierenarts
veterinarian	dierenarts
veterinary	veterinaire
vets	dierenartsen
via	via
victim	slachtoffer
vigorous	krachtig
vigorously	krachtig
viii	viii
violence	geweld
violent	heftige
violent	hevig
viral	virale
virulent	giftig
virus	virus
viruses	virussen
vision	visie
visit	bezoek
visits	bezoeken
visual	zichtbaar
vital	vitale
vitamin	vitamine
vitamins	vitaminen
vitamins	vitamines
vitreous	glasvocht
vitro	vitro
voice	stem
voiding	plassen
voltage	spanning
volume	volume
voluntarily	vrijwillig
voluntary	vrijwillig
volunteers	vrijwilligers
vomit	braken
von	von
vs	vs
vulnerable	kwetsbaar
w.	w.
wage	voeren
wagner	wagner
wait	wacht
wait	wachten
wait	wachttijd
wall	wand
wallenberg	wallenberg
walls	wanden
want	willen
wanted	gezocht
wanting	willen
wants	wil
ward	afdeling
wards	afdelingen
warm	warm
was	bevond
was	stond
was	was
wash	afwassen
wash	wassen
washing	wassen
watch	observeren
watched	bekeken
watching	volgen
water	water
waves	golven
wax	was
way	manier
way	weg
ways	manieren
we	we
we	wij
weak	zwak
weak	zwakke
weakened	verzwakt
weakened	verzwakte
weakening	verzwakking
weakness	zwakte
weapons	wapens
wear	draagt
wear	slijtage
wearer	drager
wearers	dragers
weather	weer
week	week
weeks	weken
weight	gewicht
welfare	welzijn
well	goede
well	wel
well-being	welzijn
were	waren
western	westerse
what	wat
whatever	ongeacht
whereas	terwijl
whereby	waarbij
whether	hetzij
which	waarmee
which	waarvoor
which	welk
which	welke
whilst	terwijl
white	wit
white	witte
who	wie
whom	wie
why	waarom
wide	breed
widening	verwijding
wider	breder
wife	vrouw
willebrand	willebrand
wine	wijn
wire	draad
wish	wens
withdrawn	onttrokken
without	zonder
woman	vrouw
women	vrouw
women	vrouwen
word	woord
words	woorden
work	werk
working	werkende
working	werkzaam
works	werken
workup	opbouwen
world	wereld
worldwide	wereldwijd
worms	wormen
worse	erger
worse	slechtere
worsen	verergeren
wound	wond
wound	wonden
wounded	gewonden
wrapping	omhulsel
writes	schrijft
written	geschreven
wrong	fout
wrong	mankeert
wrong	verkeerd
wrote	schreef
x	x
x-ray	röntgenfoto
x-rays	röntgenstralen
xa	x
y	y
year	jaar
yearly	jaarlijks
years	jaar
years	jaren
years	jarenlang
yeast	gist
yellow	gele
yet	nog
yield	opleveren
yielding	waardoor
yields	oplevert
yoga	yoga
york	york
you	u
young	jonge
youth	jeugd
youth	jongeren
zero	nul
zoonoses	zoönosen
zoonosis	zoönose
®	®
°	°
–	-
—	-
€	€
